13c-caffeine	13c-caffeine
bone_tumors	bone tumors
3-mehis	3-mehis
4,5-diarylisoxazoles	4,5-diarylisoxazoles
3hp-beta-lg	3hp-beta-lg
insulin_sensitivity	insulin sensitivity
idiopathic_dilated_cardiomyopathy	idiopathic dilated cardiomyopathy
cancer_of_the_bladder	cancer of the bladder
carcinoma	carcinoma
autoimmune_thyroid_diseases	autoimmune thyroid diseases
16a-hydroxyestrone	16a-hydroxyestrone
metastases	metastases
neuronal_damage	neuronal damage
4-shogaol	4-shogaol
3-ma	3-ma
characteristic_dysfunction	characteristic dysfunction
2-dehydro-emetine	2-dehydro-emetine
facial_acne_vulgaris	facial acne vulgaris
1-deamino-8-d-arginine_vasopressin_acetate_trihydrate	1-deamino-8-d-arginine vasopressin acetate trihydrate
2-mercaptoethane_sulfonate	2-mercaptoethane sulfonate
reverse_transcriptase	reverse transcriptase
myopathy	myopathy
alc	alc
1,2-sn-dag	1,2-sn-dag
3beta-methoxyserrat-14-en-21beta-ol	3beta-methoxyserrat-14-en-21beta-ol
25-hydroxyvitamin_d3	25-hydroxyvitamin d3
characteristic_toxicological_syndrome	characteristic toxicological syndrome
25oh	25oh
25-oh_d	25-oh d
5a-dihydroprogesterone	5a-dihydroprogesterone
24s-ohc	24s-ohc
3a-diol	3a-diol
12-o-tetradecanoyl_phorbol-13-acetate	12-o-tetradecanoyl phorbol-13-acetate
intestinal_ischemia	intestinal ischemia
11c-pk11195	11c-pk11195
anxiety_disorder	anxiety disorder
14,15-epoxyeicosatrienoic_acids	14,15-epoxyeicosatrienoic acids
hplc-ms	hplc-ms
4dmp	4dmp
esophageal_squamous_cell_carcinoma	esophageal squamous cell carcinoma
synovitis	synovitis
hypersensitivity	hypersensitivity
gbm	gbm
2ag	2ag
myopia	myopia
rheumatoid_arthritis	rheumatoid arthritis
deeper_skin_tumor	deeper skin tumor
2-tridecanone	2-tridecanone
cultured_melanoma	cultured melanoma
2-methylserotonin	2-methylserotonin
liver_tumors	liver tumors
tamoxifen-resistant_breast_cancer	tamoxifen-resistant breast cancer
2-chlorodeoxyadenosine	2-chlorodeoxyadenosine
hema	hema
12-o-tetradecanoylphorbol_13-acetate	12-o-tetradecanoylphorbol 13-acetate
intrauterine_fetal_death	intrauterine fetal death
myocardial_heat_shock	myocardial heat shock
malformations	malformations
t2d	t2d
25-oh-d3	25-oh-d3
necrosis	necrosis
deficient_or_insufficient	deficient or insufficient
1-nitrosocyclohexylacetate	1-nitrosocyclohexylacetate
alkaline_phosphatase	alkaline phosphatase
hyperinsulinemic-euglycemic_clamp_test	hyperinsulinemic-euglycemic clamp test
2,2-diphenyl-4-isopropylaminobutyramidmethyliodide	2,2-diphenyl-4-isopropylaminobutyramidmethyliodide
4-methyl-2,6-di-isobornyl_phenol	4-methyl-2,6-di-isobornyl phenol
4-chloro-7-nitrobenzo-2-oxa-1,3-diazole	4-chloro-7-nitrobenzo-2-oxa-1,3-diazole
pulmonary_disorders	pulmonary disorders
osteoradionecrosis_for_tongue_base_carcinoma	osteoradionecrosis for tongue base carcinoma
ectopic_intracranial_retinoblastoma	ectopic intracranial retinoblastoma
2vo	2vo
malignant_melanoma	malignant melanoma
4-hhe	4-hhe
4-hydroxy-2,2,6,6-tetramethylpiperidine-1-oxyl	4-hydroxy-2,2,6,6-tetramethylpiperidine-1-oxyl
3-chloro-1,2-propanediol	3-chloro-1,2-propanediol
cmv_and_herpes_simplex_virus_infections	cmv and herpes simplex virus infections
chronic_lymphatic_leukaemia	chronic lymphatic leukaemia
gastric_and_duodenal_fistulas	gastric and duodenal fistulas
neurologic_and_oncologic_diseases	neurologic and oncologic diseases
t-cell_lymphoproliferative_disorders	t-cell lymphoproliferative disorders
2-oxoadenosine	2-oxoadenosine
hyperplasia	hyperplasia
1,2,6-tri-o-galloyl-beta-d-glucopyranose	1,2,6-tri-o-galloyl-beta-d-glucopyranose
neonatal_anoxia	neonatal anoxia
3-methyl-histamine	3-methyl-histamine
cervical_cancer	cervical cancer
huntington_disease-like_symptoms	huntington disease-like symptoms
4-methyl-2,6-diisobornylphenol	4-methyl-2,6-diisobornylphenol
systemic_sarcoidosis	systemic sarcoidosis
17-ajb	17-ajb
endometrial_carcinoma	endometrial carcinoma
mao	mao
pituitary_stalk_infiltration	pituitary stalk infiltration
3-bromopyruvate_acid	3-bromopyruvate acid
2-aminosteroid	2-aminosteroid
1-oleoyl-2-acetyl-sn-glycerol	1-oleoyl-2-acetyl-sn-glycerol
1,2,3,4,6-penta-o-galloyl-beta-d-glucopyranoside	1,2,3,4,6-penta-o-galloyl-beta-d-glucopyranoside
125i-propylthiouracil	125i-propylthiouracil
2-n-di-n-butylaminoethanol	2-n-di-n-butylaminoethanol
non-coronary_artery_disease	non-coronary artery disease
2-aminopurine	2-aminopurine
sps	sps
unstable_angina	unstable angina
nad	nad
13-hydroperoxyoctadecadienoic_acid	13-hydroperoxyoctadecadienoic acid
falciparum_malaria	falciparum malaria
4-aminomethyl-1-benzylpyrrolidine-2-one_hemifumarate	4-aminomethyl-1-benzylpyrrolidine-2-one hemifumarate
leukemic_blasts	leukemic blasts
lung_tumor	lung tumor
oral_leukoplakia	oral leukoplakia
3,5-diiodothyropropionic_acid	3,5-diiodothyropropionic acid
tension	tension
acute_coronary_syndrome	acute coronary syndrome
hypotension	hypotension
2-vinylazetidine	2-vinylazetidine
12-o-tetradecanoyl-phorbol-13-acetate	12-o-tetradecanoyl-phorbol-13-acetate
11b-hydroxysteroid	11b-hydroxysteroid
3,4_methylenedioxymethamphetamine	3,4 methylenedioxymethamphetamine
4,5-dihydroxyimidacloprid	4,5-dihydroxyimidacloprid
15-hydroperoxyu-eicosatetraenoic_acid	15-hydroperoxyu-eicosatetraenoic acid
2-mppa	2-mppa
2-pyrones	2-pyrones
yellow_fever	yellow fever
chd	chd
11-deoxycortisol	11-deoxycortisol
impairment_in_learning-memory	impairment in learning-memory
niddm	niddm
3-hydroxyacylcoenzyme_a	3-hydroxyacylcoenzyme a
weight_loss	weight loss
2,3,7,8-tcdd	2,3,7,8-tcdd
4-hydroxy	4-hydroxy
2,4-dichlorphenoxyacetic_acid	2,4-dichlorphenoxyacetic acid
1,25-dihydroxy_vitamin_d3	1,25-dihydroxy vitamin d3
12-methacryloyloxydodecylpyridinium_bromide	12-methacryloyloxydodecylpyridinium bromide
5-aminosalicylic_acids	5-aminosalicylic acids
hypersensitivity_to_ovalbumin	hypersensitivity to ovalbumin
cardiac_toxicity	cardiac toxicity
evans_blue_leakage	evans blue leakage
17-alpha_hydroxyprogesterone_caproate	17-alpha hydroxyprogesterone caproate
5-amino-levulinic_acid	5-amino-levulinic acid
3,5-dinitrobenzoate	3,5-dinitrobenzoate
dcchds	dcchds
neurodegenarative_illnesses	neurodegenarative illnesses
bca	bca
b_lymphoma	b lymphoma
3-deoxyglucosone	3-deoxyglucosone
lactase_deficiency	lactase deficiency
1,4-benzoxazepin-2,6-dichloropurine	1,4-benzoxazepin-2,6-dichloropurine
3,6-dihydroxyflavone	3,6-dihydroxyflavone
compensatory_hyperparathyroidism	compensatory hyperparathyroidism
cho	cho
degeneration_of_serotoninergic_neurons	degeneration of serotoninergic neurons
melanotic_melanomas	melanotic melanomas
hyperplastic_alveolar_nodules	hyperplastic alveolar nodules
primary_breast_cancer_lesions	primary breast cancer lesions
bone_metastases	bone metastases
tumor_hypoxia	tumor hypoxia
adiposity	adiposity
hypertrophic_cardiomyopathy	hypertrophic cardiomyopathy
4-hc	4-hc
2c-e	2c-e
terminal_degeneration	terminal degeneration
in_vitro_fertilization	in vitro fertilization
2,4-dinitrophenyl	2,4-dinitrophenyl
4ooh-ifa	4ooh-ifa
3-methoxytyramine	3-methoxytyramine
14c_glucose	14c glucose
nodular_pulmonary_langerhans_cell_histiocytosis_lesions	nodular pulmonary langerhans cell histiocytosis lesions
4-pb	4-pb
liver_and_bladder_tumours	liver and bladder tumours
hereditary_disorder	hereditary disorder
1-aminocyclopropane-1-carboxylic_acid	1-aminocyclopropane-1-carboxylic acid
2-hydroxyflavanone	2-hydroxyflavanone
3-methoxy-4-hydrophenylglycol	3-methoxy-4-hydrophenylglycol
lead_poisoning	lead poisoning
autonomic_nervous_dysfunction	autonomic nervous dysfunction
4-n-octylphenol	4-n-octylphenol
11-dehydrocorticosterone	11-dehydrocorticosterone
177lu-eb-psma-617	177lu-eb-psma-617
sphingomyelins_of_bovine_kidney_and_intestinal_mucosa	sphingomyelins of bovine kidney and intestinal mucosa
osteogenic_sarcoma	osteogenic sarcoma
heavy_metal_poisoning	heavy metal poisoning
esophageal_adenocarcinoma	esophageal adenocarcinoma
amd	amd
trickle-bed_air_biofilter	trickle-bed air biofilter
bmd	bmd
non-lymphoid_leukemia	non-lymphoid leukemia
cf-lvad	cf-lvad
vascular_injury	vascular injury
premenstrual_syndrome	premenstrual syndrome
gastrointestinal_lesions	gastrointestinal lesions
1,25d3-marrs	1,25d3-marrs
4-amino	4-amino
inflammation_and_viral_infections	inflammation and viral infections
3-o-methylglucose	3-o-methylglucose
a_parkinson-like_syndrome	a parkinson-like syndrome
chronic_phase_chronic_myelogenous_leukemia	chronic phase chronic myelogenous leukemia
hyperplastic_nodules	hyperplastic nodules
colitis-associated_cancer	colitis-associated cancer
2,2-diphenyl-picrylhydrazyl	2,2-diphenyl-picrylhydrazyl
5-ala-pdt	5-ala-pdt
1-arylsulfonyl-2-imidazolidinones	1-arylsulfonyl-2-imidazolidinones
3-hydroxyacyl-coa	3-hydroxyacyl-coa
1,3-dnb	1,3-dnb
3-oxoolean-12-en-27-oic_acid	3-oxoolean-12-en-27-oic acid
gra	gra
ami	ami
antigen-presenting_cells	antigen-presenting cells
osteosarcoma	osteosarcoma
esophageal_carcinoma	esophageal carcinoma
inflammation_and_lupus-like_disease	inflammation and lupus-like disease
high-performance_liquid_chromatography	high-performance liquid chromatography
xeroderma_pigmentosum	xeroderma pigmentosum
5-aminoisoquinolinone	5-aminoisoquinolinone
4-allylbenzene-1,2-diol	4-allylbenzene-1,2-diol
ileitis	ileitis
14c-aminopyrine	14c-aminopyrine
1-methyl-2-mercaptoimidazole	1-methyl-2-mercaptoimidazole
preterm_labor	preterm labor
hope	hope
1-chloroacetophenone	1-chloroacetophenone
2-alpha-difluoromethylornithine	2-alpha-difluoromethylornithine
2-methoxyestradiol	2-methoxyestradiol
dermatitis	dermatitis
1-alkyl-2-acyl-sn-glycero-3-phosphocholine	1-alkyl-2-acyl-sn-glycero-3-phosphocholine
3-nitropropionic_acid	3-nitropropionic acid
asbestos	asbestos
2,3-dimethoxy-1,4-naphthoquinone	2,3-dimethoxy-1,4-naphthoquinone
pigment_dispersion	pigment dispersion
1,2-dimethylhydrazine	1,2-dimethylhydrazine
3rd_nordic_symposium	3rd nordic symposium
mustard_gas	mustard gas
mj	mj
1,4-benzoquinone	1,4-benzoquinone
cia	cia
3,4-diaminopyridine	3,4-diaminopyridine
sls	sls
51cr_edta	51cr edta
nvamd	nvamd
17dd-yfv	17dd-yfv
a-t	a-t
1,2,3,4,6-penta-o-galloyl-b-d-glucopyranose	1,2,3,4,6-penta-o-galloyl-b-d-glucopyranose
14c-acetaminophen	14c-acetaminophen
2-bromolysergic_acid_diethylamide	2-bromolysergic acid diethylamide
transient_cerebral_ischemia	transient cerebral ischemia
rhabdomyosarcoma	rhabdomyosarcoma
aggression	aggression
3,5-dmap	3,5-dmap
4-deoxypyridoxine	4-deoxypyridoxine
manic-depressive	manic-depressive
2-pam	2-pam
2-fa	2-fa
smc	smc
3-mca	3-mca
3-methylindole	3-methylindole
3-acdon	3-acdon
yf	yf
3n-butyrate	3n-butyrate
3-iodothyronamine	3-iodothyronamine
bone_lesions	bone lesions
11-beta	11-beta
colon_tumorigenesis	colon tumorigenesis
serotonin_dysfunction	serotonin dysfunction
lung_cancers	lung cancers
111in-sb3	111in-sb3
1-deamino_8d-arginine_vasopressin	1-deamino 8d-arginine vasopressin
renal_parenchyma	renal parenchyma
memory_impairments	memory impairments
5-amino-4-oxopentanoic_acid	5-amino-4-oxopentanoic acid
paracervical_block	paracervical block
cancer_model_systems	cancer model systems
4-aminophenol	4-aminophenol
123i-meta-iodobenzylguanidine	123i-meta-iodobenzylguanidine
cardiovascular_mortality	cardiovascular mortality
1-cinnamoyl-3,11-dihydroxymeliacarpin	1-cinnamoyl-3,11-dihydroxymeliacarpin
omd	omd
14c-labeled_glyburide	14c-labeled glyburide
4c	4c
oedema	oedema
3ap	3ap
myeloma	myeloma
17-ohds	17-ohds
4-alkoxy	4-alkoxy
3-deazaneoplanocin_a	3-deazaneoplanocin a
1,4-benzenedicarboxylate	1,4-benzenedicarboxylate
amnesia	amnesia
adenocarcinoma_of_the_prostate	adenocarcinoma of the prostate
s-adenosylhomocysteine_hydrolase	s-adenosylhomocysteine hydrolase
2-faa	2-faa
1-ethyl-3-methylimidazolium_tetrafluoroborate	1-ethyl-3-methylimidazolium tetrafluoroborate
2-methylbutane	2-methylbutane
reduction_in_cancer_number	reduction in cancer number
reflux_agitation	reflux agitation
18-fludeoxyglucose	18-fludeoxyglucose
2-c-hydroxymethylribofuranosylpurines	2-c-hydroxymethylribofuranosylpurines
congenital_myasthenic_syndrome	congenital myasthenic syndrome
1,1,3,3-tetramethylguanidine	1,1,3,3-tetramethylguanidine
glucosidase_ii_activity	glucosidase ii activity
epileptic	epileptic
polycythemia	polycythemia
nh-pco	nh-pco
bd	bd
active_infection	active infection
2-ag	2-ag
metastases_of_malignant_melanoma	metastases of malignant melanoma
colitis	colitis
177lu-dotatoc	177lu-dotatoc
-3_fatty_acid	-3 fatty acid
4-fluoroamphetamine	4-fluoroamphetamine
pds	pds
1-deazaadenosine	1-deazaadenosine
diabetes_insipidus	diabetes insipidus
reduction_of_oedema	reduction of oedema
5,12-dihydroxy-6,8,10,14-eicosatetraenoic_acid	5,12-dihydroxy-6,8,10,14-eicosatetraenoic acid
von_hippel-lindau_protein_levels	von hippel-lindau protein levels
fibromatosis	fibromatosis
leptomeningeal_metastases	leptomeningeal metastases
18-ethynyl-deoxycorticosterone	18-ethynyl-deoxycorticosterone
4-o-methylhonokiol	4-o-methylhonokiol
5,10-ch2fh4	5,10-ch2fh4
maladaptive_denture	maladaptive denture
5-alpha_steroid	5-alpha steroid
neurological_disease	neurological disease
intestinal_diseases	intestinal diseases
testicular_atrophy	testicular atrophy
similar_impairments	similar impairments
synchronous_lung_cancers	synchronous lung cancers
1,3-butylen_glycol	1,3-butylen glycol
pof	pof
4-methoxy-tpa	4-methoxy-tpa
chl	chl
critical_illness	critical illness
14c-serotonin	14c-serotonin
3-hydroxy-bap	3-hydroxy-bap
3-bromopyruvate	3-bromopyruvate
3-hydroxy-3-methylglutaryl_coenzyme_a	3-hydroxy-3-methylglutaryl coenzyme a
dna-damage	dna-damage
thyroid_incidentalomas	thyroid incidentalomas
2-amino-4-nitrophenol	2-amino-4-nitrophenol
hiv-1_protease	hiv-1 protease
hippocampus_and_cortex_ipsilateral_to_injury	hippocampus and cortex ipsilateral to injury
3h-saxitoxin	3h-saxitoxin
albuminuria	albuminuria
repetitive_giant_ipsps	repetitive giant ipsps
1,2-dimethyl-hydrazine	1,2-dimethyl-hydrazine
13-cis	13-cis
atherosclerotic_plaque	atherosclerotic plaque
genital_cancer	genital cancer
scfe	scfe
methylmalonic_aciduria	methylmalonic aciduria
pelvic_pain	pelvic pain
17_tetrahydroisoquinoline	17 tetrahydroisoquinoline
123i-beta-methyl-iodophenylpentadecanoic_acid	123i-beta-methyl-iodophenylpentadecanoic acid
cardiac_infarction	cardiac infarction
52-amino-acid	52-amino-acid
pme	pme
colonic_tumors	colonic tumors
chronic_myelogenous_leukemia	chronic myelogenous leukemia
15,16-dihydrotanshinone_i	15,16-dihydrotanshinone i
2-sec-butylphenyl_methylcarbamate	2-sec-butylphenyl methylcarbamate
1-methylinosine	1-methylinosine
xpd	xpd
rickets	rickets
septic_shock	septic shock
17ohp-c	17ohp-c
2,8-dihydroxyadenine	2,8-dihydroxyadenine
2-butoxyethanol	2-butoxyethanol
precancerous_diseases	precancerous diseases
diffuse_large_b-cell_lymphoma	diffuse large b-cell lymphoma
1-methyl-2-imidazolethiol	1-methyl-2-imidazolethiol
12139c	12139c
4-ca	4-ca
3-0-methyl-glucopyranose	3-0-methyl-glucopyranose
prom	prom
lymphoma_lesions	lymphoma lesions
1-amino-4-butanol	1-amino-4-butanol
3,4-dihydroxyphenylacetic_acid	3,4-dihydroxyphenylacetic acid
bone_pain	bone pain
impaired_semen_quality	impaired semen quality
3-morpholinosydnonimine	3-morpholinosydnonimine
3-ap	3-ap
acute_hemolytic_anemia	acute hemolytic anemia
erythrolytic_nephrosis	erythrolytic nephrosis
diabetic_apoe-deficient	diabetic apoe-deficient
motor_impairment	motor impairment
ehrlich_ascites_tumour	ehrlich ascites tumour
prostate_cancers	prostate cancers
1-methyl-4-phenyl-1,2,3,6-tetrahydropyridine_hydrochloride	1-methyl-4-phenyl-1,2,3,6-tetrahydropyridine hydrochloride
brain-dead	brain-dead
vad	vad
succinic_semialdehyde_dehydrogenase_deficiency	succinic semialdehyde dehydrogenase deficiency
3,4-dhb	3,4-dhb
dystonia	dystonia
es	es
sciatic_nerve_injury	sciatic nerve injury
oxidative_stress	oxidative stress
phaeochromocytomas	phaeochromocytomas
1,2-nq	1,2-nq
125i	125i
ganglia	ganglia
1,5-benzodiazepine	1,5-benzodiazepine
2-acetylaminofluorene	2-acetylaminofluorene
2,5,7-tricarbo-substituted_indoles	2,5,7-tricarbo-substituted indoles
14c-tyrosine	14c-tyrosine
25oh-vitamin_d	25oh-vitamin d
2-amino-5-phosphonopentanoic_acid	2-amino-5-phosphonopentanoic acid
1-alkenyl-paf	1-alkenyl-paf
10-propargyl-5,8-dideazafolate	10-propargyl-5,8-dideazafolate
retard_epileptogenesis	retard epileptogenesis
28-homobrassinolide	28-homobrassinolide
pheochromocytomas_and_paragangliomas	pheochromocytomas and paragangliomas
3-methoxy-4-hydroxyphenylethyleneglycol	3-methoxy-4-hydroxyphenylethyleneglycol
lupus-like_disease	lupus-like disease
1242-mg	1242-mg
impaired_glucose_tolerance	impaired glucose tolerance
ovarian_vein	ovarian vein
carcinoma_of_the_breast	carcinoma of the breast
2,4-diamino-6-piperidinopyrimidine-3-oxide	2,4-diamino-6-piperidinopyrimidine-3-oxide
disorders_of_eye_movements	disorders of eye movements
13-azaprostanoic_acid	13-azaprostanoic acid
clonal_osteoblast-like_rat_osteogenic_sarcoma	clonal osteoblast-like rat osteogenic sarcoma
3-methylglutaconic	3-methylglutaconic
1,2-dag	1,2-dag
33i	33i
leiomyoma	leiomyoma
psoriatic	psoriatic
graft-versus-host_disease	graft-versus-host disease
3hp	3hp
vitamin_d_deficiency	vitamin d deficiency
1-d-methyltryptophan	1-d-methyltryptophan
3-hydroxy-3-methylglutaryl_coenzyme-a	3-hydroxy-3-methylglutaryl coenzyme-a
3-alkynyl_selenophene	3-alkynyl selenophene
17-allylamino-17-demethoxygeldanamycin	17-allylamino-17-demethoxygeldanamycin
haemorrhagic_necrosis	haemorrhagic necrosis
11-oh_thc	11-oh thc
testicular_disorders	testicular disorders
2-acetamido-2-deoxy-d-galactonolactone	2-acetamido-2-deoxy-d-galactonolactone
mbh	mbh
neoplastic_meningitis	neoplastic meningitis
srs	srs
1-octanol	1-octanol
breast_cancers	breast cancers
3h-vesamicol	3h-vesamicol
tnbc	tnbc
dental_papilla	dental papilla
tuberous_sclerosis	tuberous sclerosis
gastric_adenocarcinoma	gastric adenocarcinoma
cardiovascular_responses	cardiovascular responses
neurotoxins	neurotoxins
17b-e	17b-e
3-mcpd	3-mcpd
14c-lactose	14c-lactose
vascular_malformations	vascular malformations
chronic_renal_failure	chronic renal failure
osteoblastic_osteosarcoma	osteoblastic osteosarcoma
3-phenethyl-2-indolinone	3-phenethyl-2-indolinone
dose_oral_toxicity	dose oral toxicity
acromegaly	acromegaly
1_alpha-hydroxycholecalciferol	1 alpha-hydroxycholecalciferol
3-o-methyl-n-acetyl-d-glucosamine	3-o-methyl-n-acetyl-d-glucosamine
diabetic_foot_ulcers	diabetic foot ulcers
escc	escc
hbl	hbl
546c88	546c88
tm	tm
cerebral_glioblastoma	cerebral glioblastoma
4-psq	4-psq
adrenal_zona_glomerulosa	adrenal zona glomerulosa
4-hydroxy-phenyl-retinamide	4-hydroxy-phenyl-retinamide
2-nnt	2-nnt
adenocarcinoma_of_the_endometrium	adenocarcinoma of the endometrium
2-cholorodeoxyadenosine	2-cholorodeoxyadenosine
13f-1	13f-1
3,4-benzpyrene	3,4-benzpyrene
4-chloro-m-cresol	4-chloro-m-cresol
1-deoxygalactonojirimycin	1-deoxygalactonojirimycin
3-dbp	3-dbp
4alphapdd	4alphapdd
intra-abdominal_candidiasis	intra-abdominal candidiasis
10-mdp	10-mdp
3-r-pod	3-r-pod
35s-furosemide	35s-furosemide
1-amino-lactose	1-amino-lactose
photodynamic_therapy	photodynamic therapy
4-phenylcoumarins	4-phenylcoumarins
1-palmitoyl-2-glutaroyl-phosphatidylcholine	1-palmitoyl-2-glutaroyl-phosphatidylcholine
hypersensitivity_reaction	hypersensitivity reaction
ki-1_lymphoma	ki-1 lymphoma
bladder_tumors	bladder tumors
systemic_mast_cell_disease	systemic mast cell disease
131iodine	131iodine
cv	cv
fatigue	fatigue
neonatal_lesion	neonatal lesion
3-oxoglutarate	3-oxoglutarate
basal_ganglia_germinoma	basal ganglia germinoma
4-carbamoylimidazolium_5-olate	4-carbamoylimidazolium 5-olate
on	on
25-hydroxycholestrol	25-hydroxycholestrol
squamous_cell_carcinoma_of_the_skin	squamous cell carcinoma of the skin
1,2_dog	1,2 dog
metabolic_bone_disease	metabolic bone disease
1,6-naphthyridine-7-carboxamide	1,6-naphthyridine-7-carboxamide
proliferative_pulmonary_lesions	proliferative pulmonary lesions
ependymoblastoma	ependymoblastoma
3ohb	3ohb
cardiac_and_vascular_remodelling	cardiac and vascular remodelling
biotin_deficiency	biotin deficiency
lordosis	lordosis
nigrostriatal_toxicity	nigrostriatal toxicity
ad	ad
2-deoxy-l-ribose	2-deoxy-l-ribose
2-hxmp	2-hxmp
infarct	infarct
tropical_pulmonary_eosinophilia	tropical pulmonary eosinophilia
kidney_slices	kidney slices
13-methyl-palmatrubine	13-methyl-palmatrubine
1.8-cineol	1.8-cineol
12-oxo-phytodienoic_acid	12-oxo-phytodienoic acid
1-deamino-8d-arginine_vasopressin	1-deamino-8d-arginine vasopressin
4-n-alkylgemcitabine	4-n-alkylgemcitabine
ms	ms
macrocytic-megaloblastic_anemia	macrocytic-megaloblastic anemia
1,3-dic8	1,3-dic8
170h-progesterone	170h-progesterone
metabolic_disorders	metabolic disorders
hearing_loss	hearing loss
mcao	mcao
sbma	sbma
nm	nm
14c-testosterone	14c-testosterone
chronic_diseases	chronic diseases
3,4-dichloropropionanilide	3,4-dichloropropionanilide
23-hta	23-hta
imt	imt
ptc	ptc
2,4-dichlorophenoxy_acetic_acid	2,4-dichlorophenoxy acetic acid
3,2-hydroxybakuchiol	3,2-hydroxybakuchiol
fcpd	fcpd
11-ketodihydrotestosterone	11-ketodihydrotestosterone
2-thiouracil_sulfonamides	2-thiouracil sulfonamides
1,3-butanediol	1,3-butanediol
2-hydroxy	2-hydroxy
helicobacter_pylori_infection	helicobacter pylori infection
2,3,5-triphenyltetrazolium	2,3,5-triphenyltetrazolium
3-hydroxyisobutyrate	3-hydroxyisobutyrate
18-hydroxy-11-deoxycorticosterone	18-hydroxy-11-deoxycorticosterone
123i-labeled_metaiodobenzylguanidine	123i-labeled metaiodobenzylguanidine
phpt	phpt
embryo_lethality	embryo lethality
glut1_deficiency	glut1 deficiency
brain_neoplasms	brain neoplasms
3-aminopyridine-2-carboxaldehyde_thiosemicarbazone	3-aminopyridine-2-carboxaldehyde thiosemicarbazone
2-chloro-5-nitro-n-phenylbenzamide	2-chloro-5-nitro-n-phenylbenzamide
takotsubo_syndrome	takotsubo syndrome
3-triol	3-triol
food_poisoning	food poisoning
ornithine_transcarbamylase_deficiency	ornithine transcarbamylase deficiency
hi_injury	hi injury
acute_pulmonary_edema	acute pulmonary edema
3-methylcholantrene	3-methylcholantrene
idiopathic_hypereosinophilic_syndrome	idiopathic hypereosinophilic syndrome
2-b4o	2-b4o
renal_failure	renal failure
4-nqo	4-nqo
17-dmag	17-dmag
oliguric_uremia	oliguric uremia
metabolic_inhibition	metabolic inhibition
hdi	hdi
3-o-sulfated_heparan_sulfate	3-o-sulfated heparan sulfate
tumour_necrosis	tumour necrosis
active_distal_ulcerative_colitis	active distal ulcerative colitis
4-amino-1-hydroxybutylidene-1,1-bisphosphonate	4-amino-1-hydroxybutylidene-1,1-bisphosphonate
4-hydroxyestrone	4-hydroxyestrone
buccal_cancer	buccal cancer
adrenal_incidentalomas	adrenal incidentalomas
10-ethyl-10-deaza-aminopterin	10-ethyl-10-deaza-aminopterin
acute_kidney_injury	acute kidney injury
cm	cm
protein_kinase_c	protein kinase c
dilated_cardiomyopathy	dilated cardiomyopathy
svci	svci
25-hcc	25-hcc
2-amino-3h-phenoxazin-3-one	2-amino-3h-phenoxazin-3-one
18b-ga	18b-ga
hairy_cell_leukaemia	hairy cell leukaemia
nd	nd
infertility	infertility
adrenocortical_hyperfunction	adrenocortical hyperfunction
14c-leucine	14c-leucine
tpc	tpc
3-oola	3-oola
14cdta-tetc	14cdta-tetc
mpn	mpn
hypercholesteremia	hypercholesteremia
4-methyl-3-nitrobenzoic_acid	4-methyl-3-nitrobenzoic acid
anastomosis	anastomosis
1-methyl-4-phenylpyridnium	1-methyl-4-phenylpyridnium
18f-fdg	18f-fdg
ct	ct
ovarian_venous_blood_and_ovaries	ovarian venous blood and ovaries
3h-glucosamine	3h-glucosamine
25-ohd	25-ohd
25c-nbome	25c-nbome
acute_lung_injury	acute lung injury
schistosomiasis	schistosomiasis
postmenopausal_bone_loss	postmenopausal bone loss
2-4_dinitrochlorobenzene	2-4 dinitrochlorobenzene
4-arylidene_curcumin	4-arylidene curcumin
tachycardia	tachycardia
malignant_pheochromocytoma	malignant pheochromocytoma
prostate_carcinoma	prostate carcinoma
2,4_dinitrophenol	2,4 dinitrophenol
4-methyl-umbelliferyl-beta-d-galactopyranoside	4-methyl-umbelliferyl-beta-d-galactopyranoside
186re-1,1-hydroxyethylidene_diphosphonate	186re-1,1-hydroxyethylidene diphosphonate
meningioma	meningioma
insulinoma	insulinoma
131cscl	131cscl
heat_pain	heat pain
candidal_infections	candidal infections
2-methoxyjuglone	2-methoxyjuglone
sickle-cell_anemia	sickle-cell anemia
flame_retardants	flame retardants
2-mercaptoethane_sulphonate	2-mercaptoethane sulphonate
hemangiosarcomas	hemangiosarcomas
5-amino-4-imidazolecarboxamide_riboside	5-amino-4-imidazolecarboxamide riboside
vasospasm	vasospasm
2-cado	2-cado
4-o-methyl	4-o-methyl
3-nitrosobenzamide	3-nitrosobenzamide
3h-thymidine	3h-thymidine
2mesamp	2mesamp
3,5,6-trichloro-2-pyridinol	3,5,6-trichloro-2-pyridinol
4-methylumbelliferyl-beta-d-galactoside	4-methylumbelliferyl-beta-d-galactoside
20,25-diazacholesterol	20,25-diazacholesterol
bovine_ovaries_toward_dehydroepiandrosterone	bovine ovaries toward dehydroepiandrosterone
type	type
cdms	cdms
2-buten-4-olide	2-buten-4-olide
ischemic_stroke	ischemic stroke
10-hydroxycamptothecine	10-hydroxycamptothecine
18f-labeled_fluconazole	18f-labeled fluconazole
retinopathy	retinopathy
4-hydroxyphenyl_retinamide	4-hydroxyphenyl retinamide
lc	lc
chf	chf
superficial_basal_cell_carcinoma	superficial basal cell carcinoma
mucosal_injury	mucosal injury
2,9-dimethyl-1,10-phenanthroline	2,9-dimethyl-1,10-phenanthroline
embolic_stroke	embolic stroke
urticaria	urticaria
alpha-l-iduronidase_deficiency	alpha-l-iduronidase deficiency
4-o-mh	4-o-mh
1-alpha-hydroxy_vitamin_d3	1-alpha-hydroxy vitamin d3
molecular_dynamics	molecular dynamics
1-ethyl-3-methylimidazolium_salts	1-ethyl-3-methylimidazolium salts
5,6-dihydroxyindole	5,6-dihydroxyindole
5alpha-androstan-17-one	5alpha-androstan-17-one
2-methoxycinnamaldehyde	2-methoxycinnamaldehyde
inverted_papilloma	inverted papilloma
4-hydroxybenzoic_acid	4-hydroxybenzoic acid
1,4,5,8-naphthalene_diimide	1,4,5,8-naphthalene diimide
-3_fatty_acid_eicosapentaenoic_acid	-3 fatty acid eicosapentaenoic acid
3-carboxylic_esters	3-carboxylic esters
4,8-dimethylcoumarin	4,8-dimethylcoumarin
head_and_neck	head and neck
16,16-dimethyl_pge2-methyl-ester	16,16-dimethyl pge2-methyl-ester
heterotopic_pancreatitis	heterotopic pancreatitis
glc_and_glc-ms	glc and glc-ms
kyphosis	kyphosis
impaired_glucose_metabolism	impaired glucose metabolism
zikv_infection	zikv infection
brain_after_global_cerebral_ischemia	brain after global cerebral ischemia
1,6-diphosphate	1,6-diphosphate
1,1-diphenyl-2-picrylhydrazyl	1,1-diphenyl-2-picrylhydrazyl
infective_endocarditis	infective endocarditis
5-amino-7-methyl-1:2:4:6-tetra-azaindene	5-amino-7-methyl-1:2:4:6-tetra-azaindene
active_pulmonary_tuberculosis	active pulmonary tuberculosis
28-o-propynoylbetulin	28-o-propynoylbetulin
ait	ait
nasopharyngeal_carcinoma	nasopharyngeal carcinoma
1,1-diphenyl-2-picryl-hydrazyl	1,1-diphenyl-2-picryl-hydrazyl
12-o-tetradecanoylphorbol-3-acetate	12-o-tetradecanoylphorbol-3-acetate
acute_infection	acute infection
16-methylene-prednisolone	16-methylene-prednisolone
3h_leucine	3h leucine
obesity	obesity
3-hydroxy-3-methyl_glutaryl_coenzyme_a	3-hydroxy-3-methyl glutaryl coenzyme a
2,3-dihydro-1h-indolizinium_alkaloid-prosopilosidine	2,3-dihydro-1h-indolizinium alkaloid-prosopilosidine
4-mei	4-mei
330-440_mbq_18f-fluorodeoxyglucose	330-440 mbq 18f-fluorodeoxyglucose
3sd	3sd
hhd	hhd
neuropathy	neuropathy
postmenopausal_symptoms	postmenopausal symptoms
1,3-butylene_glycol	1,3-butylene glycol
malignant_epithelial_and_mesenchymal_skin_tumors	malignant epithelial and mesenchymal skin tumors
24s-oh	24s-oh
1-3galnac	1-3galnac
3-ost-5	3-ost-5
3-bromopyruvate_propyl_ester	3-bromopyruvate propyl ester
amyloid_toxicity	amyloid toxicity
123i-bmipp	123i-bmipp
staging_of_carcinoma_of_the_cervix	staging of carcinoma of the cervix
lah	lah
epileptiform_spiking	epileptiform spiking
5-aminolaevulinic_acid-pdt	5-aminolaevulinic acid-pdt
mpnst	mpnst
11c-met	11c-met
primary_biliary_cirrhosis	primary biliary cirrhosis
xerostomia	xerostomia
morris_hepatoma	morris hepatoma
11-cis-retinal	11-cis-retinal
impaired_renal_function	impaired renal function
13n-glutamic_acid	13n-glutamic acid
11-mercaptoundecanoic_acid	11-mercaptoundecanoic acid
epileptiform_bursts	epileptiform bursts
epidural_block	epidural block
15c-urea	15c-urea
ulcerative_proctitis	ulcerative proctitis
1,3-d	1,3-d
sudden_death	sudden death
cardiovascular_and_central_nervous_system_toxicity	cardiovascular and central nervous system toxicity
gsa	gsa
fse	fse
1-butanol	1-butanol
cross_immunological_reactions	cross immunological reactions
1790n	1790n
3-amino-1,2,4-benzotriazine_1,4-dioxide	3-amino-1,2,4-benzotriazine 1,4-dioxide
5,14-hedge	5,14-hedge
crescentic_glomerulonephritis	crescentic glomerulonephritis
emerson-trinder_reaction	emerson-trinder reaction
acute_necrotizing_ulcerative_gingivitis	acute necrotizing ulcerative gingivitis
1-phenyl-3-methyl-4-acyl-pyrazol-5-ols	1-phenyl-3-methyl-4-acyl-pyrazol-5-ols
1,4-naphthoquinone	1,4-naphthoquinone
2-aminofluorene	2-aminofluorene
rigidity	rigidity
4-hydroperoxy_ifosfamide	4-hydroperoxy ifosfamide
avos	avos
19-deoxyicetexone	19-deoxyicetexone
mastocytoma	mastocytoma
2,4,6-tribromophenol	2,4,6-tribromophenol
ovarian_tumor	ovarian tumor
3-pufas	3-pufas
posttraumatic_stress_disorder	posttraumatic stress disorder
adrenal_metastases	adrenal metastases
2-fluoro-2-deoxy-d-glucose	2-fluoro-2-deoxy-d-glucose
neurologic_symptoms	neurologic symptoms
1,1-disubstituted_olefin	1,1-disubstituted olefin
104e	104e
langerhans_cell_histiocytosis	langerhans cell histiocytosis
13c	13c
vulvar_lichen_sclerosus	vulvar lichen sclerosus
3k3a-apc	3k3a-apc
125i-iothalamate	125i-iothalamate
isolated_preeclampsia	isolated preeclampsia
fractured_molar_tooth	fractured molar tooth
cpa	cpa
24,25-dihydroxyvitamin_d	24,25-dihydroxyvitamin d
neurodegenerative_disorders	neurodegenerative disorders
arrhythmias	arrhythmias
steatosis	steatosis
2-me-l	2-me-l
complete_abortion	complete abortion
gastrointestinal_cancer	gastrointestinal cancer
mesotheliomas	mesotheliomas
125iodine	125iodine
dissolved_inorganic_nitrogen	dissolved inorganic nitrogen
poisonings	poisonings
thyroid_carcinoma	thyroid carcinoma
mhpg	mhpg
bph	bph
ndi	ndi
3tc-tp	3tc-tp
calvarial_osteoblasts	calvarial osteoblasts
2-hydroxybenzylamine_acetate	2-hydroxybenzylamine acetate
human_uroepithelial_cells	human uroepithelial cells
4-bpre	4-bpre
bacterial_infections	bacterial infections
ra	ra
cardiomyopathy	cardiomyopathy
acute_leukemias	acute leukemias
1,5-anhydro-d-glucitol	1,5-anhydro-d-glucitol
eac	eac
pld	pld
3-methylphthalide	3-methylphthalide
skin_cancers	skin cancers
fracture	fracture
2-n-octylthiophene	2-n-octylthiophene
20-hydroxyeicosatetraenoic_acid	20-hydroxyeicosatetraenoic acid
mci	mci
1h-mrs	1h-mrs
sclc	sclc
postcholecystectomy_t-tube_drainage	postcholecystectomy t-tube drainage
motor_abnormalities	motor abnormalities
acute_interstitial_pneumonia	acute interstitial pneumonia
3,5-dbr-l-phe	3,5-dbr-l-phe
3-hydroxyglutarate	3-hydroxyglutarate
18-hydroxy_11-deoxycorticosterone	18-hydroxy 11-deoxycorticosterone
3-hm	3-hm
cerebellar_ataxia	cerebellar ataxia
dysplasia	dysplasia
4862f	4862f
14c-prednimustine	14c-prednimustine
18f-fspg	18f-fspg
3-methyadenine	3-methyadenine
protozoan_crithidia_fasciculata	protozoan crithidia fasciculata
1,2-propanediol	1,2-propanediol
tenderness	tenderness
male_pseudohermaphroditism	male pseudohermaphroditism
2,3-dpg	2,3-dpg
endogenous_depression	endogenous depression
2-aaa	2-aaa
hyponatremia	hyponatremia
2-aminochromones	2-aminochromones
1,5-ag	1,5-ag
cancer_of_the_uterine_cervix	cancer of the uterine cervix
testicular_and_epididymal_toxicity	testicular and epididymal toxicity
3-methyl-cholanthrene	3-methyl-cholanthrene
5-aminolaevulinic	5-aminolaevulinic
cutaneous_hypersensitivity_reactions	cutaneous hypersensitivity reactions
1-carbon	1-carbon
20e	20e
malignant_disease	malignant disease
breast_and_gastric_cancer	breast and gastric cancer
2-deoxy-d-galactose	2-deoxy-d-galactose
hepatic_hemangioma	hepatic hemangioma
131i-6beta-iodocholesterol	131i-6beta-iodocholesterol
global_developmental_delay	global developmental delay
pseudohermaphroditism	pseudohermaphroditism
hypothermia	hypothermia
3-ppp	3-ppp
2-chloro-n6-cyclopentyladenosine	2-chloro-n6-cyclopentyladenosine
iron_overload	iron overload
intramedullary_ependymoma	intramedullary ependymoma
caries	caries
5,6-dimethylxanthenone-4-acetic_acid	5,6-dimethylxanthenone-4-acetic acid
preneoplastic_lesions	preneoplastic lesions
2,6-dinitrotoluene	2,6-dinitrotoluene
neurotoxicity	neurotoxicity
chronic_pain	chronic pain
heart_failure	heart failure
2cda	2cda
mouse_carcinoma	mouse carcinoma
3-0-toloxy-1,2-propanediol	3-0-toloxy-1,2-propanediol
non-small_cell_lung_cancers	non-small cell lung cancers
3-beta-hydroxy-5-cholenic_acid	3-beta-hydroxy-5-cholenic acid
malaria	malaria
3-hmp	3-hmp
contact_hypersensitivity	contact hypersensitivity
miscarriage	miscarriage
dentinal_carious_lesions	dentinal carious lesions
labeling_index	labeling index
lung_cancer	lung cancer
mda-mb-435s_cancer	mda-mb-435s cancer
3-dhs	3-dhs
hypoparathyroidism	hypoparathyroidism
hemiplegia	hemiplegia
fmt	fmt
27-hydroxycholesterol	27-hydroxycholesterol
irritant_contact_dermatitis	irritant contact dermatitis
1-beta-d-arabinosyl_cytosine	1-beta-d-arabinosyl cytosine
4-androstene-dione	4-androstene-dione
3-methyl-4-hydroxy-mandelic_acid	3-methyl-4-hydroxy-mandelic acid
22-ene-25-oxa-vitamin_d	22-ene-25-oxa-vitamin d
19-noraldosterone	19-noraldosterone
infantile_intrahepatic_cholestasis	infantile intrahepatic cholestasis
3-haa	3-haa
hippocampal_injury	hippocampal injury
1,4,5,8-naphthalenetetracarboxylic_diimide	1,4,5,8-naphthalenetetracarboxylic diimide
ple	ple
hypotensive	hypotensive
1-octyne	1-octyne
sp	sp
mantle_cell_lymphoma	mantle cell lymphoma
1,2-dipalmitoyl-sn-glycero-3-phosphoethanolamine	1,2-dipalmitoyl-sn-glycero-3-phosphoethanolamine
2,5-hd	2,5-hd
tad	tad
1,2-dichloropropane	1,2-dichloropropane
4-methylthiobenzoic_acid	4-methylthiobenzoic acid
mouse_leukemia_l1210	mouse leukemia l1210
cardiac_motion	cardiac motion
3-methylsulphonyl-dde	3-methylsulphonyl-dde
1,2-dihydroxybenzene	1,2-dihydroxybenzene
1,5-benzothiazepine_calcium	1,5-benzothiazepine calcium
uremic	uremic
22r-hydroxycholesterol	22r-hydroxycholesterol
ird	ird
hemorrhagic_cystitis	hemorrhagic cystitis
headache	headache
escherichia_coli_beta-galactosidase	escherichia coli beta-galactosidase
degeneration_of_tyrosine_hydroxylase	degeneration of tyrosine hydroxylase
papillomata	papillomata
1-palmitoyl-2-oleoyl-sn-glycero-3-phosphatidylcholine	1-palmitoyl-2-oleoyl-sn-glycero-3-phosphatidylcholine
convulsive	convulsive
kidney_tumors	kidney tumors
17alpha-estradiol	17alpha-estradiol
3,4-methylene_dioxymethamphetamine	3,4-methylene dioxymethamphetamine
rcc	rcc
3-chloromethylthiochromone-1,1-dioxide	3-chloromethylthiochromone-1,1-dioxide
1,5-cyclooctadiene	1,5-cyclooctadiene
primary_malignant_brain_tumors	primary malignant brain tumors
2-naphthylamine	2-naphthylamine
2,6-diisopropylphenol	2,6-diisopropylphenol
depression-like_syndrome	depression-like syndrome
solid_tumors	solid tumors
neoplasia	neoplasia
3-aminopropyltriethoxysilane	3-aminopropyltriethoxysilane
1,3-dipropyl-8-sulphophenylxanthine	1,3-dipropyl-8-sulphophenylxanthine
apl	apl
4h3mc	4h3mc
wolman_disease	wolman disease
tem	tem
2-methyl-adenosine	2-methyl-adenosine
ovarian_surface_epithelial	ovarian surface epithelial
4-guanidino-neu5ac2en	4-guanidino-neu5ac2en
3co	3co
cin	cin
inferior_myocardial_defect	inferior myocardial defect
3-isobutyl-1-methylxanthine	3-isobutyl-1-methylxanthine
2-amino-3-benzoylthiophenes	2-amino-3-benzoylthiophenes
renal_nerve_activity	renal nerve activity
degeneration_of_cells	degeneration of cells
gastric_mucosal_injury	gastric mucosal injury
pancreatic_carcinogenesis	pancreatic carcinogenesis
carambola_l	carambola l
cll	cll
3,5-dicqa	3,5-dicqa
2-arachidonoyl_glycerol	2-arachidonoyl glycerol
hairy-cell_leukemia	hairy-cell leukemia
18f-ah111585	18f-ah111585
fluorescence-guided_surgery	fluorescence-guided surgery
3-acetyl-5-methyltetronic_acid	3-acetyl-5-methyltetronic acid
1,3,6-trinitropyrene	1,3,6-trinitropyrene
lymph_nodes	lymph nodes
cardiotoxicity	cardiotoxicity
21-ohd	21-ohd
4-pyridinethiol	4-pyridinethiol
hiv-1_strains	hiv-1 strains
10-hcpt	10-hcpt
13c-glucose	13c-glucose
mouse_epidermis	mouse epidermis
unit-leukemia	unit-leukemia
chronic_obstructive_pulmonary_disease	chronic obstructive pulmonary disease
carotenoids	carotenoids
cirrhosis	cirrhosis
1-cortienic_acid	1-cortienic acid
renal_necrosis	renal necrosis
2-hydroxyestrone	2-hydroxyestrone
retina_damage	retina damage
1,2-diamino-4,5-dibromobenzene	1,2-diamino-4,5-dibromobenzene
2-bromoethylamine_hydrobromide	2-bromoethylamine hydrobromide
1,2-dihexadecylphosphatidylcholine	1,2-dihexadecylphosphatidylcholine
2af	2af
hypophosphatemia	hypophosphatemia
2-mca	2-mca
5_aminosalicylic_acid	5 aminosalicylic acid
stretch_injury	stretch injury
sca	sca
juvenile_rheumatoid_arthritis	juvenile rheumatoid arthritis
15n	15n
25-oh-vd3	25-oh-vd3
4-fluoro-3-nitroaniline	4-fluoro-3-nitroaniline
lytic_cmv_infection	lytic cmv infection
renal_excretion	renal excretion
elicited_weaker_beta-galactosidase_activity	elicited weaker beta-galactosidase activity
cognitive_benefits	cognitive benefits
14c-triolein	14c-triolein
2,4,6-trinitrobenzenesulfonic_acid	2,4,6-trinitrobenzenesulfonic acid
wild-type	wild-type
nip	nip
ards	ards
inguinal_hernia	inguinal hernia
2-alpha-thiomethylmercuryl_9-acetamido-9-deoxy-sialoside	2-alpha-thiomethylmercuryl 9-acetamido-9-deoxy-sialoside
colon_carcinoma	colon carcinoma
cord_paralysis	cord paralysis
fractures	fractures
hepatic_cancer	hepatic cancer
mm	mm
sarcoma	sarcoma
1-thyroxine	1-thyroxine
non-cross-link_and_cross-link_ages_and_ales	non-cross-link and cross-link ages and ales
demyelinating_disease	demyelinating disease
4-o-methylpyridoxine	4-o-methylpyridoxine
23bb	23bb
moyamoya_disease	moyamoya disease
myasthenia_gravis	myasthenia gravis
1,3-dcp	1,3-dcp
hypothalamic-pituitary-thyroid_axis	hypothalamic-pituitary-thyroid axis
crpcs	crpcs
intracranial_meningiomas	intracranial meningiomas
visual_cortex_lesion	visual cortex lesion
10-microl	10-microl
1-25-hydroxyvitamine_d	1-25-hydroxyvitamine d
renal_hypertrophy	renal hypertrophy
1-methyl_4-phenyl-1,2,3,6_tetrahydropyridine	1-methyl 4-phenyl-1,2,3,6 tetrahydropyridine
4-phenylbutyric_acid	4-phenylbutyric acid
4-nitro-n-phenylbenzamide	4-nitro-n-phenylbenzamide
3-npa	3-npa
inherited_disease	inherited disease
pituitary_spindle_cell_carcinoma	pituitary spindle cell carcinoma
1,1,1,3,3-pentafluoropropane	1,1,1,3,3-pentafluoropropane
3-vo	3-vo
sickle_cell_disease	sickle cell disease
2-amino-5-phosphonovaleric_acid	2-amino-5-phosphonovaleric acid
insulin-deficient_diabetes	insulin-deficient diabetes
lung_squamous_cell_carcinoma	lung squamous cell carcinoma
ovarian_teratomas	ovarian teratomas
liver_injury	liver injury
melanoma_tumor	melanoma tumor
brucellosis	brucellosis
5,10-methenyltetrahydrofolate	5,10-methenyltetrahydrofolate
2-mercaptoethanol	2-mercaptoethanol
maturity	maturity
1-hydroxypyrene	1-hydroxypyrene
4-hydroxyphenylretinamide	4-hydroxyphenylretinamide
carnitine_palmitoyltransferase	carnitine palmitoyltransferase
carotid_imt	carotid imt
2-deoxycoformycin	2-deoxycoformycin
2,5-dimethylpyrrole	2,5-dimethylpyrrole
51cr-edta	51cr-edta
diabetic_coma	diabetic coma
pituitary_tumor	pituitary tumor
3-hydroxy-3methylglutaryl_coenzyme_a	3-hydroxy-3methylglutaryl coenzyme a
1_alpha_hydroxy_cholecalciferol	1 alpha hydroxy cholecalciferol
cardiac_remodeling	cardiac remodeling
edema	edema
3-benzoyl-1-methyl-4-phenyl-4-piperidinol_hydrochloride	3-benzoyl-1-methyl-4-phenyl-4-piperidinol hydrochloride
mpnsts	mpnsts
pylori_infection	pylori infection
2-allyl-2-isopropylacetamide	2-allyl-2-isopropylacetamide
2-amino-1-thiazolyl_imidazoles	2-amino-1-thiazolyl imidazoles
1,25_vitamin_d3	1,25 vitamin d3
adrenocortical_cancer	adrenocortical cancer
rfs	rfs
hypoxia-induced_functional_failure	hypoxia-induced functional failure
advanced_breast_cancer	advanced breast cancer
1-methyl-4-phenyl-1,2,3,6-tetrahydropyridinium	1-methyl-4-phenyl-1,2,3,6-tetrahydropyridinium
3-t	3-t
scl-gvhd	scl-gvhd
13bhcl	13bhcl
3h	3h
aortic_valve_damage	aortic valve damage
15-n-nervonoyl_sphingosine	15-n-nervonoyl sphingosine
3mc	3mc
hiv-infection	hiv-infection
chc	chc
pancreatic_cystic_tumors	pancreatic cystic tumors
psoriatic_arthritis	psoriatic arthritis
metastatic_neuroblastoma	metastatic neuroblastoma
drug-resistant_epilepsy	drug-resistant epilepsy
gastric_ulcers	gastric ulcers
15-hydroxy-eicosatetraenoic_acid	15-hydroxy-eicosatetraenoic acid
2-demethoxycarbonyl-2-ethoxycarbonyl-11-deoxymisoprostol	2-demethoxycarbonyl-2-ethoxycarbonyl-11-deoxymisoprostol
1-hydroxypyrene-2-carbaldehyde	1-hydroxypyrene-2-carbaldehyde
huvecs	huvecs
18f-choline	18f-choline
3-methylcrotonyl-coa	3-methylcrotonyl-coa
hsd	hsd
long_qt_syndrome	long qt syndrome
3,4-diaminopyridine_phosphate	3,4-diaminopyridine phosphate
2,3-dph	2,3-dph
18f-2-fluoro-2-deoxy-d-glucose	18f-2-fluoro-2-deoxy-d-glucose
1-abt	1-abt
ddd	ddd
autophagy-impaired_tumors	autophagy-impaired tumors
gt	gt
myocardial_infarcts	myocardial infarcts
hypogonadism	hypogonadism
colon_tumors	colon tumors
ventricular_fibrillation	ventricular fibrillation
colon_adenocarcinoma	colon adenocarcinoma
asthma	asthma
3-o-acetyl-11-keto-b-boswellic_acid	3-o-acetyl-11-keto-b-boswellic acid
14c-oestrone	14c-oestrone
3-br-7-ni	3-br-7-ni
cachexia	cachexia
parasites	parasites
2-methyl-1,4_naphthoquinone	2-methyl-1,4 naphthoquinone
1-hexylcarbamoyl-5-fluurouracil	1-hexylcarbamoyl-5-fluurouracil
multibacillary_leprosy	multibacillary leprosy
psychiatric_illness	psychiatric illness
renal_cell_tumors	renal cell tumors
lung_tumors	lung tumors
neurologic_disease	neurologic disease
storage_disorders	storage disorders
4-tert-butylphenyl_ester	4-tert-butylphenyl ester
macroglobulinemia	macroglobulinemia
skin_lesion	skin lesion
mammary_carcinomas	mammary carcinomas
monoamine_oxidase	monoamine oxidase
parkinsonian_syndrome	parkinsonian syndrome
ocsln	ocsln
18f-dg	18f-dg
2-amino-5-bromo-3-iodoacetophenone	2-amino-5-bromo-3-iodoacetophenone
2,4-diamino-1,6-dihydro-1,3,5-triazine	2,4-diamino-1,6-dihydro-1,3,5-triazine
1alpha-hydroxyvitamin_d3	1alpha-hydroxyvitamin d3
18-oxocortisol	18-oxocortisol
1,2-dibromo-3-chloropropane	1,2-dibromo-3-chloropropane
2,5-hexanedione	2,5-hexanedione
mf	mf
13c-nds	13c-nds
2-p-hema	2-p-hema
20c	20c
pancreatic_cancer	pancreatic cancer
aortic_atherosclerosis	aortic atherosclerosis
1,2,6-ip3	1,2,6-ip3
brain_tumor	brain tumor
bone_marrow_abnormalities	bone marrow abnormalities
13n-ammonia_and_18f-fdg	13n-ammonia and 18f-fdg
parkinsonian_symptoms	parkinsonian symptoms
15nh4cl	15nh4cl
increases_in_the_bp_and_hr	increases in the bp and hr
1-amino-2-hydroxy-guanidine	1-amino-2-hydroxy-guanidine
1-methyl-add	1-methyl-add
liver_cancers	liver cancers
5-alkyl-5-deazaaminopterin	5-alkyl-5-deazaaminopterin
2-hexyl_cyanoacrylate	2-hexyl cyanoacrylate
2,2,2-trifluoroethanol	2,2,2-trifluoroethanol
4beta-phorbol_ester_12,13-dibutyrate	4beta-phorbol ester 12,13-dibutyrate
1-methyl-2-nitrosoimidazole	1-methyl-2-nitrosoimidazole
18f-fluorodeoxyglucose	18f-fluorodeoxyglucose
3-ap_triapine	3-ap triapine
26-hydroxycholesterol	26-hydroxycholesterol
2-bromopropane	2-bromopropane
2-pyridones	2-pyridones
urea_cycle_disorders	urea cycle disorders
2-ketoglutaric_acid	2-ketoglutaric acid
1,25-vd	1,25-vd
17aag	17aag
na	na
colonic_aberrant_crypts_and_tumors	colonic aberrant crypts and tumors
skin_tumor	skin tumor
developmental_anomalies	developmental anomalies
2,2-diphenyl-4-diisopropylaminobutyramide_methyl_iodide	2,2-diphenyl-4-diisopropylaminobutyramide methyl iodide
hemolytic	hemolytic
1-sarcosine	1-sarcosine
malabsorption	malabsorption
rhabdoid_tumor	rhabdoid tumor
mip	mip
15-hete	15-hete
2-methyl-5-phenylpentanol	2-methyl-5-phenylpentanol
11-dehydrothromboxane_b2	11-dehydrothromboxane b2
1-nitro-2-phenylethane	1-nitro-2-phenylethane
2-pentenenitrile	2-pentenenitrile
4-hydroxy-5-phenyl-1,3-oxazaperhydroin-2-one	4-hydroxy-5-phenyl-1,3-oxazaperhydroin-2-one
1-o-alkyl-2-o-acetyl-sn-glyceryl-3-phosphorylcholine	1-o-alkyl-2-o-acetyl-sn-glyceryl-3-phosphorylcholine
memory_loss	memory loss
1-methyl-3-nitro-1-nitrosoguanidine	1-methyl-3-nitro-1-nitrosoguanidine
5,15-diaryl-tetrapyrrole	5,15-diaryl-tetrapyrrole
iron_in_beta_thalassaemia	iron in beta thalassaemia
milk_fever	milk fever
idiopathic_elastosis_perforans_serpiginosa	idiopathic elastosis perforans serpiginosa
1,4-diazepines	1,4-diazepines
2-oxoacid	2-oxoacid
11c-acpc	11c-acpc
3-o-methyl-d-glucopyranose	3-o-methyl-d-glucopyranose
1,2,4-triazole	1,2,4-triazole
rhabdomyolysis	rhabdomyolysis
endometrial_adenocarcinoma	endometrial adenocarcinoma
massive_coagulative_hepatic_necrosis	massive coagulative hepatic necrosis
1-hydrazinophthalazine	1-hydrazinophthalazine
1-oleoyl-2-acetyl_diglycerol	1-oleoyl-2-acetyl diglycerol
2-ndhsa	2-ndhsa
17-hydroxycorticosteroid	17-hydroxycorticosteroid
faecal_incontinence	faecal incontinence
pulmonary_hypertension	pulmonary hypertension
123i-iomazenil	123i-iomazenil
aortic_aneurysms	aortic aneurysms
early_vascular_lesion	early vascular lesion
3-in-1	3-in-1
4-vinylcyclohexene_diepoxide	4-vinylcyclohexene diepoxide
4-phenylbutyrate	4-phenylbutyrate
1-desamino-8-d-arginine_vasopressin	1-desamino-8-d-arginine vasopressin
toxic_shock	toxic shock
emergency_department	emergency department
hel	hel
4-hydroxyglutethimide	4-hydroxyglutethimide
acf	acf
adrenogenital_syndrome	adrenogenital syndrome
urothelial_carcinoma	urothelial carcinoma
3-methoxy-4-hydroxyphenylethylene_glycol	3-methoxy-4-hydroxyphenylethylene glycol
myotonia	myotonia
genotoxic_damage	genotoxic damage
18f-fhbg	18f-fhbg
2-ethoxybenzoic_acid	2-ethoxybenzoic acid
adenocarcinomas	adenocarcinomas
pakistanis	pakistanis
4-ma	4-ma
1-aminocyclopropane-1-carboxylate	1-aminocyclopropane-1-carboxylate
57co-bleomycetin	57co-bleomycetin
2-difluoromethylornithine	2-difluoromethylornithine
3-sn-polyenylphosphatidylcholine	3-sn-polyenylphosphatidylcholine
1-methyluric_acid	1-methyluric acid
18-f-fluorodeoxyglucose_positron	18-f-fluorodeoxyglucose positron
loss_of_dopaminergic_neurons	loss of dopaminergic neurons
4-s-cap	4-s-cap
od	od
promyelocytic_leukemia	promyelocytic leukemia
mammary_dysplasia	mammary dysplasia
endocardial_fibroelastosis	endocardial fibroelastosis
eae	eae
withdrawal_syndrome	withdrawal syndrome
edematous	edematous
retinal_tumors	retinal tumors
1-13c_pyruvate	1-13c pyruvate
postoperative_pancreatic_fistula	postoperative pancreatic fistula
2-tetradecylglycidic_acid	2-tetradecylglycidic acid
2-aminoethyl_diphenylborate	2-aminoethyl diphenylborate
a_21-hydroxylase_deficiency	a 21-hydroxylase deficiency
mss	mss
alpha-galactosidase	alpha-galactosidase
sickness_behavior	sickness behavior
cerebral_damage	cerebral damage
4mp	4mp
cystinuria	cystinuria
4-cp	4-cp
1,4-dihydropyridine_nifedipine	1,4-dihydropyridine nifedipine
2-chloro_deoxyadenosine	2-chloro deoxyadenosine
risk_prostate_cancer	risk prostate cancer
2md	2md
alp	alp
hdl	hdl
1-aminocyclopropanecarboxylic_acid	1-aminocyclopropanecarboxylic acid
neurological_dysfunctions	neurological dysfunctions
25-hydroxy_vitamin_d	25-hydroxy vitamin d
19-methyl	19-methyl
vascular_neoplasms	vascular neoplasms
21-deoxyaldosterone	21-deoxyaldosterone
12-hydroxyheptadecatrienoate	12-hydroxyheptadecatrienoate
lymphadenopathy	lymphadenopathy
3-phenylquinolinylchalcone	3-phenylquinolinylchalcone
remission_of_endocrine_gastroenteropancreatic_tumors	remission of endocrine gastroenteropancreatic tumors
he	he
porphyria	porphyria
3-o-methylfunicone	3-o-methylfunicone
coma	coma
snd	snd
13n-ammonia	13n-ammonia
1,25-dihydroxyvitamin_d	1,25-dihydroxyvitamin d
50-55gy	50-55gy
scd	scd
5,6,7,8-tetrahydroneopterin	5,6,7,8-tetrahydroneopterin
corneal_fibroblasts	corneal fibroblasts
rbc	rbc
1,5-isoquinolinediol	1,5-isoquinolinediol
5,7_dibromo-8-benzoyl-oxyquinaldine	5,7 dibromo-8-benzoyl-oxyquinaldine
gist	gist
infection	infection
2-pmpa	2-pmpa
pancreatic_loop	pancreatic loop
cerebral_vasculopathy	cerebral vasculopathy
sleep_disturbances	sleep disturbances
2-acylaminobenzimidazoles	2-acylaminobenzimidazoles
epsc_depression	epsc depression
ovarian_activity	ovarian activity
25-hydroxyvitamin_d	25-hydroxyvitamin d
cornea	cornea
renal_osteodystrophy	renal osteodystrophy
eye_tumors	eye tumors
lch	lch
1668-thioate	1668-thioate
adenocarcinoma	adenocarcinoma
kd	kd
hepatocellular_injury	hepatocellular injury
decreased_dissociation	decreased dissociation
4-nitrochinoline_n-oxide	4-nitrochinoline n-oxide
fibrosis	fibrosis
migration	migration
stomach_tumor	stomach tumor
lymphoproliferative_diseases	lymphoproliferative diseases
vocs	vocs
2,3-o-desulphated_heparin	2,3-o-desulphated heparin
bipolar_cells	bipolar cells
suprasellar_tumors	suprasellar tumors
dendritic_ligands	dendritic ligands
cerebral_edema	cerebral edema
myocardial_injury	myocardial injury
3h-noradrenaline	3h-noradrenaline
2,3-dimercaptopropanol	2,3-dimercaptopropanol
17-oxyprogesterone_caproate	17-oxyprogesterone caproate
hypoxia-ischemia	hypoxia-ischemia
choriocarcinoma	choriocarcinoma
islet-cell_tumors	islet-cell tumors
multilamellar_1-palmitoyl-2-linoleoyl-phosphatidylcholine_vesicles	multilamellar 1-palmitoyl-2-linoleoyl-phosphatidylcholine vesicles
vegetation_dependence	vegetation dependence
2,4-decadienal	2,4-decadienal
neural_crest_tumors	neural crest tumors
4,4-dithiodimorpholine	4,4-dithiodimorpholine
polychondritis	polychondritis
mammary_tumors	mammary tumors
liver_damage	liver damage
inflammatory_bowl_disease	inflammatory bowl disease
alveolar_septal_injury	alveolar septal injury
constrictive_injury	constrictive injury
3-da	3-da
hemolysis	hemolysis
ses	ses
fast-channel_cms	fast-channel cms
2,4-dimethylaniline	2,4-dimethylaniline
25-hydroxyvitamin-d	25-hydroxyvitamin-d
5-40	5-40
dependence	dependence
atopic_dermatitis	atopic dermatitis
baldness	baldness
hepatic_cholangiofibrosis	hepatic cholangiofibrosis
4-chlorophenyl_acetate_ester_enolate	4-chlorophenyl acetate ester enolate
3-brpa	3-brpa
14c-2-deoxyglucose	14c-2-deoxyglucose
21-hydroxylase_deficiency	21-hydroxylase deficiency
cancer_of_the_oral_mucosa	cancer of the oral mucosa
2-aryl_and_2,5-diarylfurans	2-aryl and 2,5-diarylfurans
pain_and_sensory_deficits	pain and sensory deficits
nodulocystic_acne	nodulocystic acne
hepatic_porphyrias	hepatic porphyrias
1-nitronaphthalene	1-nitronaphthalene
experimental_autoimmune_encephalomyelitis	experimental autoimmune encephalomyelitis
1,2-diacyl-sn-glycerol	1,2-diacyl-sn-glycerol
20,25_diazacholesterol	20,25 diazacholesterol
hcg	hcg
brown_alga_xiphophora_chondrophylla	brown alga xiphophora chondrophylla
malaria_anemia	malaria anemia
2-ap	2-ap
3-deoxy-2-substituted_pentacyclic_triterpenes	3-deoxy-2-substituted pentacyclic triterpenes
2-ib	2-ib
3-hpaba	3-hpaba
1-o-hexadecyl-2-acetyl-sn-glycero-3-phosphocholine	1-o-hexadecyl-2-acetyl-sn-glycero-3-phosphocholine
3alpha,5alpha-thp	3alpha,5alpha-thp
glial_dysfunction	glial dysfunction
npc	npc
2-o-tetradecanoyl_phorbol_13-acetate	2-o-tetradecanoyl phorbol 13-acetate
17a-estradiol	17a-estradiol
1bntiq	1bntiq
diabetic_retinopathy	diabetic retinopathy
opisthorchiasis	opisthorchiasis
123i-mel037	123i-mel037
16-oxo-cleroda-3,13-dien-15-oic_acid	16-oxo-cleroda-3,13-dien-15-oic acid
5-ala	5-ala
acute_leukemia	acute leukemia
3-oxo-c12-hsl	3-oxo-c12-hsl
epidural_fibrosis	epidural fibrosis
1-nco	1-nco
4-caproylamino_diphenylsulfone	4-caproylamino diphenylsulfone
2-phenoxyethanol	2-phenoxyethanol
aiha	aiha
2,4-d_ester	2,4-d ester
small-cell_lung_cancer	small-cell lung cancer
2-en-vpa	2-en-vpa
3-bmc	3-bmc
3-indole	3-indole
2-propyl-1-pentanol	2-propyl-1-pentanol
dcis	dcis
kcs	kcs
lung_lesions	lung lesions
acoustic_trauma	acoustic trauma
2,3-dihydroxypropyl-adenine	2,3-dihydroxypropyl-adenine
3-o-methyl-d-glucose	3-o-methyl-d-glucose
1-methyl_4-phenyl_1,2,3,6-tetrahydropyridine	1-methyl 4-phenyl 1,2,3,6-tetrahydropyridine
2hf	2hf
coronary_artery_disease	coronary artery disease
fh_gene_abnormalities	fh gene abnormalities
advanced_cancer	advanced cancer
ovarian_failure	ovarian failure
4-hydroxyaminoquinoline-1-oxide	4-hydroxyaminoquinoline-1-oxide
diabetes_mellitus	diabetes mellitus
2,4,5-t	2,4,5-t
sle	sle
17-a-alkylated_androgens	17-a-alkylated androgens
4-hydroperoxycyclophosphamide	4-hydroperoxycyclophosphamide
primary_central_nervous_system_lymphomas	primary central nervous system lymphomas
2,4-di-diethylamino-ethoxydesoxybenzoine_sulfate	2,4-di-diethylamino-ethoxydesoxybenzoine sulfate
1,4-benzodiazepine	1,4-benzodiazepine
3-arylisoquinolines	3-arylisoquinolines
17-b_oestradiol	17-b oestradiol
rosai-dorfman_disease	rosai-dorfman disease
5-aiq	5-aiq
2-aminoisobutyrate	2-aminoisobutyrate
1-pp	1-pp
5-a-ris	5-a-ris
4-hne	4-hne
1o2	1o2
alveolar_structures	alveolar structures
type_ii_hyperlipoproteinaemia	type ii hyperlipoproteinaemia
endotoxemia	endotoxemia
oesophageal_cancer	oesophageal cancer
neurodegeneration	neurodegeneration
3-methyleneindolenine	3-methyleneindolenine
striatal_degeneration	striatal degeneration
hcv	hcv
4-methylumbelliferylguanidinobenzoate	4-methylumbelliferylguanidinobenzoate
2ccpa	2ccpa
ketonemia	ketonemia
mlc	mlc
2-alkoxy	2-alkoxy
corticosteroid-resistant_distal_colitis	corticosteroid-resistant distal colitis
multiple_colorectal_adenocarcinomas	multiple colorectal adenocarcinomas
59fe	59fe
3,7-dimethyl-1-propargylxanthine	3,7-dimethyl-1-propargylxanthine
ih	ih
quadruple_mutant_deficient	quadruple mutant deficient
1,1-difluoroethane	1,1-difluoroethane
acute_lung_inflammation	acute lung inflammation
2,5-dihydroxybenzoic_acid	2,5-dihydroxybenzoic acid
3-ketoacyl	3-ketoacyl
pleurisy	pleurisy
hsv-1_infection	hsv-1 infection
24,24-difluoro-1,25-dihydroxycholecalciferol	24,24-difluoro-1,25-dihydroxycholecalciferol
11-dehydro-thromboxane_b2	11-dehydro-thromboxane b2
1-benzylimidazole	1-benzylimidazole
4-cld	4-cld
4-methylpyrazole	4-methylpyrazole
yoshida_ascites_tumor	yoshida ascites tumor
42k	42k
schizophrenic	schizophrenic
bladder_carcinoma	bladder carcinoma
4-nitroquinoline_n-oxide	4-nitroquinoline n-oxide
enlargement_of_the_adrenal_cortex_and_its_zona_fasciculata	enlargement of the adrenal cortex and its zona fasciculata
hepatocellular_carcinoma_liver_lesions	hepatocellular carcinoma liver lesions
deficiency_rickets	deficiency rickets
2,4,6-trichlorophenol	2,4,6-trichlorophenol
down_syndrome	down syndrome
2famp	2famp
2-ismn	2-ismn
4-hydroxycyclophosphamide	4-hydroxycyclophosphamide
lbd	lbd
3-thiadicarboxylic_acid	3-thiadicarboxylic acid
wasting_syndrome	wasting syndrome
10058-f4	10058-f4
hematological_toxicity	hematological toxicity
renal_dialysis	renal dialysis
2-ethylpyridine	2-ethylpyridine
2-hydroxyethyl_methacryl_lactate	2-hydroxyethyl methacryl lactate
ctcl	ctcl
2,3,6-tribromo-4,5-dihydroxybenzyl_methyl_ether	2,3,6-tribromo-4,5-dihydroxybenzyl methyl ether
18f-fluoro-2-deoxy-d-glucose	18f-fluoro-2-deoxy-d-glucose
2-cla	2-cla
infectious_disease	infectious disease
adhesive_capsulitis	adhesive capsulitis
vascular_inflammation	vascular inflammation
2,6-diformyl-4-methylphenol	2,6-diformyl-4-methylphenol
10-thiastearic_acid	10-thiastearic acid
5-aminosalicylate	5-aminosalicylate
4-dihydroxyl-phenyl_lactic_acid	4-dihydroxyl-phenyl lactic acid
osteoporotic	osteoporotic
gmvs	gmvs
239puo2	239puo2
low-grade_glioma	low-grade glioma
maldi-tof-ms	maldi-tof-ms
3,4-dihydroxyphenylalanine	3,4-dihydroxyphenylalanine
3,3-dimethyl-2,5-hexanedione	3,3-dimethyl-2,5-hexanedione
2hpbcd	2hpbcd
1,4-dichlorobenzene	1,4-dichlorobenzene
1-methyl-4-phenylpiridinium_iodide	1-methyl-4-phenylpiridinium iodide
12-epoxyeicosatrienoic_acid	12-epoxyeicosatrienoic acid
autochthonous_tumors	autochthonous tumors
2-aminoethanesulfonic_acid	2-aminoethanesulfonic acid
degree_of_deficiency	degree of deficiency
hypoxic_tumors	hypoxic tumors
infarct-side_coronary_artery_and_radial_artery	infarct-side coronary artery and radial artery
burkitt_lymphoma	burkitt lymphoma
2,4,6-trinitrochlorobenzene	2,4,6-trinitrochlorobenzene
18oxof	18oxof
1,7-dimethylxanthine	1,7-dimethylxanthine
2-fluoroterephthalonitrile	2-fluoroterephthalonitrile
5asa	5asa
infectious_diseases	infectious diseases
3-n-butyl_phthalide	3-n-butyl phthalide
3-nba	3-nba
3-pehpc	3-pehpc
17p	17p
5-aif	5-aif
2,4-dnt	2,4-dnt
2,4-dnp	2,4-dnp
11-doga	11-doga
2-fluoro-2-deoxyglucose_positron	2-fluoro-2-deoxyglucose positron
hepatic_coma	hepatic coma
4pytp	4pytp
2-meoemate	2-meoemate
3-bp	3-bp
1,25-hydroxyvitamin_d	1,25-hydroxyvitamin d
3,5-diiodo-l-thyronine	3,5-diiodo-l-thyronine
haemophilia_a	haemophilia a
hepatic_ischemia	hepatic ischemia
prostatic_carcinogenesis	prostatic carcinogenesis
2-troglitazone	2-troglitazone
3-np	3-np
dyskinesias	dyskinesias
cerebral_ischemia	cerebral ischemia
5-amidino-2-phenylindole	5-amidino-2-phenylindole
gestation_day	gestation day
hereditary_blindness	hereditary blindness
b-cell_cll	b-cell cll
catalepsy	catalepsy
poisoning	poisoning
platelet_retention	platelet retention
neutropenia	neutropenia
beta-n-acetylgalactosaminidase	beta-n-acetylgalactosaminidase
stomatitis	stomatitis
cervical_cancers	cervical cancers
carotid_artery_disease	carotid artery disease
13c-aminopyrine	13c-aminopyrine
3beta-hydroxysteroid	3beta-hydroxysteroid
177lu-dota-tate	177lu-dota-tate
4mu	4mu
4-nc	4-nc
vascular_dementia	vascular dementia
carcinoma_of_prostate	carcinoma of prostate
3dcrt	3dcrt
peripheral_artery_disease	peripheral artery disease
1metiq	1metiq
hypertrophy	hypertrophy
mammary_tumor	mammary tumor
ihcp	ihcp
1-methyladenosine	1-methyladenosine
trauma-hemorrhage	trauma-hemorrhage
poc	poc
nephritis	nephritis
5-aminoimidazole-4-carboxamide-1-b-d-ribofuranoside	5-aminoimidazole-4-carboxamide-1-b-d-ribofuranoside
18b-sodium_glycyrrhetinic_acid	18b-sodium glycyrrhetinic acid
seizure	seizure
3,5,3-triiodothyronine	3,5,3-triiodothyronine
osteoarthritis	osteoarthritis
2,3-dinitrilo-1,4-dithia-9,10-antraquinone	2,3-dinitrilo-1,4-dithia-9,10-antraquinone
aphasia	aphasia
heterotopic_ossification	heterotopic ossification
recalcitrant_disease	recalcitrant disease
inoculation_of_herpes_simplex_virus_type_1_limits_the_influence_of_the_virus_infection	inoculation of herpes simplex virus type 1 limits the influence of the virus infection
4-amino-3-s-glutathionylphenol	4-amino-3-s-glutathionylphenol
2,3-dimercapto-1-propane_sulfonic_acid	2,3-dimercapto-1-propane sulfonic acid
10-deoxy-10-c-morpholinoethyl	10-deoxy-10-c-morpholinoethyl
toxic_goiter	toxic goiter
1,25-dihydroxyvitamin_d3	1,25-dihydroxyvitamin d3
14c-erythritol	14c-erythritol
1-tyrosine	1-tyrosine
16,16-dimethyl_pge2	16,16-dimethyl pge2
labelling_index	labelling index
genital_carcinoma	genital carcinoma
acute_aortic_dissection	acute aortic dissection
32phosphorus	32phosphorus
1,2-dithiole-3-thiones	1,2-dithiole-3-thiones
123i-beta-methyl_iodophenyl_pentadecanoic_acid	123i-beta-methyl iodophenyl pentadecanoic acid
2-amino-5-phosphonopentanoate	2-amino-5-phosphonopentanoate
4-ethoxycarbonylethyl_curcumin	4-ethoxycarbonylethyl curcumin
suzuki-miyaura_cross-coupling	suzuki-miyaura cross-coupling
3h-imi	3h-imi
hyperuricemia	hyperuricemia
llc	llc
4-methylesculetin	4-methylesculetin
4-pp	4-pp
16-mercaptohexadecanoic_acid	16-mercaptohexadecanoic acid
panhypopituitarism	panhypopituitarism
renal_toxicity	renal toxicity
tmv_infection	tmv infection
metabolic_tumor	metabolic tumor
11-amino-1-undecanethiol	11-amino-1-undecanethiol
glaucomatous_disc_damage	glaucomatous disc damage
adh	adh
2-hexadecenal	2-hexadecenal
muscle_necrosis	muscle necrosis
3-o-acetyloleanolic_acid	3-o-acetyloleanolic acid
2,2-dioxopropyl-n-propylnitrosamine	2,2-dioxopropyl-n-propylnitrosamine
11ohd	11ohd
3d-cta	3d-cta
skin_tumors	skin tumors
4-fa	4-fa
systemic_lupus_erythematosus	systemic lupus erythematosus
12-o-tetradecanoyl-phorbol-13-ester	12-o-tetradecanoyl-phorbol-13-ester
4-ooh-if	4-ooh-if
striatal_damage	striatal damage
corrosion_behaviors	corrosion behaviors
1-methyl-4-phenyl-1,2,3,6-tetrahydropyridine	1-methyl-4-phenyl-1,2,3,6-tetrahydropyridine
shortening	shortening
2-ohe2	2-ohe2
1,3,7-tripropylxanthine	1,3,7-tripropylxanthine
definitive_implantation_in_the_treatment_of_some_apical_and_non_apical_lung_tumors	definitive implantation in the treatment of some apical and non apical lung tumors
10-oxa-5,8-dideazafolic_acid	10-oxa-5,8-dideazafolic acid
3-ohb	3-ohb
1,3-cyclohexadiene	1,3-cyclohexadiene
13-methyltetradecanoic_acid	13-methyltetradecanoic acid
hip_fracture	hip fracture
5alpha,3beta-p	5alpha,3beta-p
membranous_glomerulonephritis	membranous glomerulonephritis
bpd	bpd
hydrocephalus	hydrocephalus
3-oxo-delta_4-steroid	3-oxo-delta 4-steroid
4-terpineol	4-terpineol
5-aminosalicylates	5-aminosalicylates
arterial_injury	arterial injury
15-f2t-isop	15-f2t-isop
1-amino-3-borono-cyclopentanecarboxylic_acid	1-amino-3-borono-cyclopentanecarboxylic acid
1-aryl-3-amino-1-propanone_hydrochlorides	1-aryl-3-amino-1-propanone hydrochlorides
epigenetic_dysregulation	epigenetic dysregulation
4-methyl-5-amino-1-formylisoquinoline_thiosemicarbazone	4-methyl-5-amino-1-formylisoquinoline thiosemicarbazone
visceral_hypersensitivity	visceral hypersensitivity
17-n-allylamino-17-demethoxygeldanamycin	17-n-allylamino-17-demethoxygeldanamycin
4-oh-cpa	4-oh-cpa
2-acetyl_furanonaphthoquinone	2-acetyl furanonaphthoquinone
25-oh_vitamin_d	25-oh vitamin d
18f-thk5351	18f-thk5351
neurotoxic_damage	neurotoxic damage
16,16-dimethyl-trans-delta_2_prostaglandin_e1_methyl_ester	16,16-dimethyl-trans-delta 2 prostaglandin e1 methyl ester
3-pufa	3-pufa
14-c-tryptamine	14-c-tryptamine
2-cda	2-cda
adenocarcinoma_of_the_urethra	adenocarcinoma of the urethra
metaplasia	metaplasia
177lu-dotatate	177lu-dotatate
1-deamino-8-d-arginine_vasopressin	1-deamino-8-d-arginine vasopressin
2,3,5-triphenyltetrazolium_chloride_triazole	2,3,5-triphenyltetrazolium chloride triazole
autism_spectrum_disorders	autism spectrum disorders
hemorrhoids	hemorrhoids
sexual_and_erectile_dysfunction	sexual and erectile dysfunction
hyperpigmentation	hyperpigmentation
1-methylnicotinamide	1-methylnicotinamide
pituitary_adenomas	pituitary adenomas
memory_impairment	memory impairment
22c3	22c3
1,4-bis-trichloromethylbenzol	1,4-bis-trichloromethylbenzol
pulmonary_toxicity	pulmonary toxicity
3b-hydroxysteroid	3b-hydroxysteroid
cardiovascular_disease	cardiovascular disease
2,4-dithiobiuret	2,4-dithiobiuret
ketothiolase_deficiency	ketothiolase deficiency
4-chlorodiphenyl_ether	4-chlorodiphenyl ether
188re-hedp	188re-hedp
3,4-benzopyrene	3,4-benzopyrene
15-18_cmh2o	15-18 cmh2o
17-aag	17-aag
pneumonia	pneumonia
2,6-di-o-methyl-beta-cyclodextrin	2,6-di-o-methyl-beta-cyclodextrin
3h-proline	3h-proline
alcoholic	alcoholic
1-oleoyl_lysophosphatidic_acid	1-oleoyl lysophosphatidic acid
depression	depression
3,7-dihydroxy-isoflav-3-ene	3,7-dihydroxy-isoflav-3-ene
mec	mec
2-butanol	2-butanol
4-ipp	4-ipp
14c-glucose	14c-glucose
neuronal_apoptosis	neuronal apoptosis
19-norvitamin_d	19-norvitamin d
interstitial_fibrosis	interstitial fibrosis
21-aminosteroid_u-74389g	21-aminosteroid u-74389g
cerebral_infarction	cerebral infarction
1-mt	1-mt
maximal_electroshock-induced_seizures	maximal electroshock-induced seizures
neuroendocrine_tumor	neuroendocrine tumor
10-hydroxycamptothecin	10-hydroxycamptothecin
paraneoplastic_limbic_encephalitis	paraneoplastic limbic encephalitis
12-o-tetradecanoly_phorbol-13-acetate	12-o-tetradecanoly phorbol-13-acetate
1,25_dihydroxyvitamin_d	1,25 dihydroxyvitamin d
basal_cell_nevus_syndrome	basal cell nevus syndrome
11-deoxycorticosterone	11-deoxycorticosterone
tonic-clonic_and_electrographic_seizures	tonic-clonic and electrographic seizures
17b-oestradiol	17b-oestradiol
behavioral_deficits	behavioral deficits
splenic_marginal_zone_lymphomas	splenic marginal zone lymphomas
atherosclerotic_lesions	atherosclerotic lesions
amenorrhea	amenorrhea
hfref	hfref
polycystic_kidney	polycystic kidney
2-propyl-pentanoic_acid	2-propyl-pentanoic acid
hepatotoxicity	hepatotoxicity
4-hydroxyestradiol	4-hydroxyestradiol
neuronal_plasticity	neuronal plasticity
copper_covered	copper covered
4-chlorophenol	4-chlorophenol
17-dimethylaminoethylamino-17-demethoxygeldanamycin	17-dimethylaminoethylamino-17-demethoxygeldanamycin
st-elevation_myocardial_infarction	st-elevation myocardial infarction
31p	31p
inflammatory_demyelinating_disease	inflammatory demyelinating disease
cryptococcosis	cryptococcosis
1-pentanol	1-pentanol
1-beta-d-arabinofuranosyl-5-azacytosine	1-beta-d-arabinofuranosyl-5-azacytosine
colonic_tumor	colonic tumor
ha	ha
3,5-dicarbomethoxyphenylbiguanide	3,5-dicarbomethoxyphenylbiguanide
25-oh_d3	25-oh d3
3,4-amino-1,2,4-triazole	3,4-amino-1,2,4-triazole
3h-spiroperidol	3h-spiroperidol
suberoylanilide_hydroxamic_acid	suberoylanilide hydroxamic acid
131-i-metaidobenzylguanidine	131-i-metaidobenzylguanidine
tumors	tumors
2-hydroxychalcone	2-hydroxychalcone
mitotic_arrest	mitotic arrest
3-methyl-1-butanol	3-methyl-1-butanol
15n-glycine	15n-glycine
2-octylcyanoacrylate	2-octylcyanoacrylate
tetanus	tetanus
tma-2	tma-2
11_beta-hydroxysteroid	11 beta-hydroxysteroid
thrombosis	thrombosis
2,3-diarylindole	2,3-diarylindole
prostatic_cancer	prostatic cancer
zdf	zdf
1,2,4-trimethyl_benzene	1,2,4-trimethyl benzene
4-nitroquinoline_1_oxide	4-nitroquinoline 1 oxide
arthritis	arthritis
depressive_symptoms	depressive symptoms
alcohol_dehydrogenase	alcohol dehydrogenase
4-mu	4-mu
17_beta-estradiol	17 beta-estradiol
germ_cell_tumors	germ cell tumors
2-hexylcyclopentanone	2-hexylcyclopentanone
phaeochromocytomas_and_paragangliomas	phaeochromocytomas and paragangliomas
rarer_cancers	rarer cancers
mean_standing_time	mean standing time
asd	asd
pseudomonas_vesicularis	pseudomonas vesicularis
15d-pgj2	15d-pgj2
1-deoxynojirimycin	1-deoxynojirimycin
liver_lesions	liver lesions
2pf	2pf
1-methyl-4-phenyl_pyridine	1-methyl-4-phenyl pyridine
hyperostoses	hyperostoses
1,24,25-trihydroxyvitamin_d3	1,24,25-trihydroxyvitamin d3
hdp	hdp
11a-o-benzoyl-12b-o-acetyltenacigenin_b	11a-o-benzoyl-12b-o-acetyltenacigenin b
dtc	dtc
17-allylamino_geldanamycin	17-allylamino geldanamycin
anti-glomerular_basement_membrane_disease	anti-glomerular basement membrane disease
2,4,6-trinitrobenzene_sulfonate	2,4,6-trinitrobenzene sulfonate
4-epidoxorubicin	4-epidoxorubicin
2,3-dehydrosilybin	2,3-dehydrosilybin
2-mercaptopropionylglycine	2-mercaptopropionylglycine
1-deamino-8-d-arginine	1-deamino-8-d-arginine
anhedonia	anhedonia
2,6-dichlorobenzylidene_aminoguanidine	2,6-dichlorobenzylidene aminoguanidine
short_stature_and_skeletal_deformities	short stature and skeletal deformities
human_immunodeficiency_virus	human immunodeficiency virus
2-aryl_propionic_acid	2-aryl propionic acid
1-benzhydryl-sulfonyl-piperazine	1-benzhydryl-sulfonyl-piperazine
2-pentanone	2-pentanone
hypercholesterolemic	hypercholesterolemic
2-hydroxyl	2-hydroxyl
20_alpha-hydroxysteroid	20 alpha-hydroxysteroid
determinants_of_endotoxemia	determinants of endotoxemia
rpe	rpe
tic	tic
2,7-dibromocarbazole	2,7-dibromocarbazole
3-arylindanones	3-arylindanones
2,4-dichlorophenoxyactic_acid	2,4-dichlorophenoxyactic acid
3,4-dihydroxyacetophenone	3,4-dihydroxyacetophenone
1-indanone	1-indanone
osteonecrosis	osteonecrosis
neuroendocrine_tumors	neuroendocrine tumors
10-cl-bbq	10-cl-bbq
increased_squamous_cell_carcinoma	increased squamous cell carcinoma
18f-av-1451	18f-av-1451
3-methylcyclopentanone	3-methylcyclopentanone
3_a-diol	3 a-diol
developmental_defect	developmental defect
sd	sd
1rm	1rm
cheilitis	cheilitis
ileocecal_adenocarcinoma	ileocecal adenocarcinoma
cpt	cpt
os	os
2-aminothiophenol	2-aminothiophenol
autoimmune_diseases	autoimmune diseases
13c-galactose	13c-galactose
malignancies	malignancies
3-fat	3-fat
57co-cyanocobalamin	57co-cyanocobalamin
reduced_bone_turnover	reduced bone turnover
chronic_lymphocytic_leukaemia	chronic lymphocytic leukaemia
4-methylhistamine	4-methylhistamine
18f-fes	18f-fes
17-beta_estradiol	17-beta estradiol
3-mc	3-mc
3hm-hbg	3hm-hbg
rabbit_platelet_aggregation	rabbit platelet aggregation
adrenal_carcinoma	adrenal carcinoma
cyanide_poisoning	cyanide poisoning
3h-oleic_or_3h-arachidonic_acids	3h-oleic or 3h-arachidonic acids
1-methyl-4-phenylpyridinium	1-methyl-4-phenylpyridinium
primary_ovarian_insufficiency	primary ovarian insufficiency
ubte	ubte
sarcoidosis	sarcoidosis
psychomotor	psychomotor
atrophy	atrophy
5,6-dihydroxy-indole-2-carboxylic_acid	5,6-dihydroxy-indole-2-carboxylic acid
odp	odp
2-pyridine_aldoxime_methochloride	2-pyridine aldoxime methochloride
hepatic_haem_turnover	hepatic haem turnover
mbd	mbd
13asa	13asa
2-methoxyethanol	2-methoxyethanol
tuberculosis	tuberculosis
2-methyl-1,4-naphthoquinone	2-methyl-1,4-naphthoquinone
17alpha-hydroxyprogesterone	17alpha-hydroxyprogesterone
toxicities	toxicities
2-cyanaziridines	2-cyanaziridines
3,4-dihydroxybenzylamine	3,4-dihydroxybenzylamine
20-hete	20-hete
tremors	tremors
3,4-methlylenedioxymethamphetamine	3,4-methlylenedioxymethamphetamine
1-naphthylisothiocyanate	1-naphthylisothiocyanate
1,2-dichloroethane	1,2-dichloroethane
hyperthyroidism	hyperthyroidism
2,4,6-triethylenimino-s-triazine	2,4,6-triethylenimino-s-triazine
hyperglycemia	hyperglycemia
4-oh_tamoxifen	4-oh tamoxifen
heartburn	heartburn
3-bromo_and_3-iodo	3-bromo and 3-iodo
1-hexylcarbamoyl-5-fluorouracil	1-hexylcarbamoyl-5-fluorouracil
2,4-dichloro-1-nitrobenzene	2,4-dichloro-1-nitrobenzene
acute_lymphoblastic_leukemia	acute lymphoblastic leukemia
3h-daunorubicin	3h-daunorubicin
4-n-alkanoylgemcitabine	4-n-alkanoylgemcitabine
epileptics	epileptics
2-methyl-1,2-epoxypropane	2-methyl-1,2-epoxypropane
2,6,10,14-tetramethylpentadecane	2,6,10,14-tetramethylpentadecane
cholesterol_depletion	cholesterol depletion
1h10-dox	1h10-dox
1-methyl-4-phenyl-1,2,5,6-tetrahydropyridine	1-methyl-4-phenyl-1,2,5,6-tetrahydropyridine
b-cell_lymphoma	b-cell lymphoma
cardiovascular_complications	cardiovascular complications
3aoa	3aoa
11-dehydro_thromboxane_b2	11-dehydro thromboxane b2
4-thujanol	4-thujanol
cbl_deficiency	cbl deficiency
2,4-dichlorophenoxyacetate	2,4-dichlorophenoxyacetate
pre-eclampsia	pre-eclampsia
granulocytic_sarcoma	granulocytic sarcoma
1,2_dimethylhydrazine	1,2 dimethylhydrazine
proteinuria	proteinuria
hyperaldosteronism	hyperaldosteronism
liver_diseases	liver diseases
alpha-hydroxylase_deficiency	alpha-hydroxylase deficiency
abs	abs
188re-perrhenate	188re-perrhenate
systemic_anaphylaxis	systemic anaphylaxis
renal_and_urinary_disorders	renal and urinary disorders
experimental_myotonia	experimental myotonia
2-methylthio_atp	2-methylthio atp
infections	infections
10-substituted_1,6-diazaphenothizines	10-substituted 1,6-diazaphenothizines
5-aminoimidazole-4-carboxamide-1-beta-4-ribofuranoside	5-aminoimidazole-4-carboxamide-1-beta-4-ribofuranoside
cardiac_apoptosis	cardiac apoptosis
4-hydroxyisoleucine	4-hydroxyisoleucine
1a-25-dihydroxyvitamin_d3	1a-25-dihydroxyvitamin d3
1-palmitoyl-lysophosphatidylcholine	1-palmitoyl-lysophosphatidylcholine
1-chloro-2-methylpropene	1-chloro-2-methylpropene
virus_infection	virus infection
1,2-sn-diacylglycerols	1,2-sn-diacylglycerols
17_beta-hydroxysteroid	17 beta-hydroxysteroid
2-amino-5-phosphonovalerate	2-amino-5-phosphonovalerate
adrenocortical_disorders	adrenocortical disorders
hyperkalemic_cardioplegia	hyperkalemic cardioplegia
monocytic_leukemia	monocytic leukemia
lewis_lung_carcinoma	lewis lung carcinoma
1,25_dihydroxyvitamin_d3	1,25 dihydroxyvitamin d3
18f-2-fluorodeoxysorbitol	18f-2-fluorodeoxysorbitol
24-epibrassinolide	24-epibrassinolide
development_of_tongue_carcinoma	development of tongue carcinoma
19-nor-contraceptives	19-nor-contraceptives
3-mercaptophenylboronic_acid	3-mercaptophenylboronic acid
1-oleoyl-2-acetylglycerol	1-oleoyl-2-acetylglycerol
beta-thalassemia	beta-thalassemia
gastroesophageal_reflux	gastroesophageal reflux
1,2-benzopyrone	1,2-benzopyrone
13-hydroxyoctadecadienoic_acid	13-hydroxyoctadecadienoic acid
4-chloro-o-phenylenediamine	4-chloro-o-phenylenediamine
1,6-hexamethylene_diamine	1,6-hexamethylene diamine
neuroblastoma	neuroblastoma
1,3-bg	1,3-bg
post-traumatic_stress_disorder	post-traumatic stress disorder
acute_lymphocytic_leukemia	acute lymphocytic leukemia
overweight_and_obesity	overweight and obesity
4-sulfate	4-sulfate
4-oha	4-oha
2-aryl-n-methylsuccinimides	2-aryl-n-methylsuccinimides
4-methylumbelliferryl-alpha-l-iduronide	4-methylumbelliferryl-alpha-l-iduronide
2-naphthalene	2-naphthalene
1,3-dioxoindan-2-carboxylic_acid_arylamides	1,3-dioxoindan-2-carboxylic acid arylamides
4-s-cysteaminylphenol	4-s-cysteaminylphenol
large-vessel_vasculitis	large-vessel vasculitis
4-iodophenylalanine	4-iodophenylalanine
1,6-dnp	1,6-dnp
cortisone_reductase_deficiency	cortisone reductase deficiency
18b-glycyrrhetinic_acid	18b-glycyrrhetinic acid
ks	ks
4-hydroxy-2-nonenal	4-hydroxy-2-nonenal
1-cyclobutanecarbonyl-3,3-dimethylurea	1-cyclobutanecarbonyl-3,3-dimethylurea
lymphoproliferative_disorders	lymphoproliferative disorders
acute_and_chronic_myeloblastic_leukemias	acute and chronic myeloblastic leukemias
jh	jh
11c-labeled_acetate	11c-labeled acetate
1,1-dichloro-2-propanone	1,1-dichloro-2-propanone
long-lasting_central_nervous_system	long-lasting central nervous system
venous_anomalies	venous anomalies
13c-acid	13c-acid
18gly	18gly
3h-lysergic_acid_diethylamide	3h-lysergic acid diethylamide
neurodegenerative_diseases	neurodegenerative diseases
acute_renal_failure	acute renal failure
superficial_bladder_cancer	superficial bladder cancer
4-alpha-phorbol_12,13_didecanoate	4-alpha-phorbol 12,13 didecanoate
accessory_optic_system	accessory optic system
3-mpa	3-mpa
1,5-hexadiene	1,5-hexadiene
hyperactivity	hyperactivity
15-hydroxyeicosatetraenoic_acid	15-hydroxyeicosatetraenoic acid
cholestasis	cholestasis
sers	sers
2,4-d	2,4-d
neurological_deficit	neurological deficit
reactive_oxygen_species	reactive oxygen species
1-deoxy-1-fluoro-scyllo-inositol	1-deoxy-1-fluoro-scyllo-inositol
intrahepatic_cholestasis	intrahepatic cholestasis
4-hydroxy-3-methoxycinnamic_acid	4-hydroxy-3-methoxycinnamic acid
aml	aml
25-hydroxycholesterol	25-hydroxycholesterol
chronic_kidney_disease	chronic kidney disease
2br-dab	2br-dab
15-epi-lxa4	15-epi-lxa4
cerebral_amyloid_angiopathy	cerebral amyloid angiopathy
coccidioidal_infection	coccidioidal infection
osteoporotic_fractures	osteoporotic fractures
uninvestigated_dyspepsia_symptoms	uninvestigated dyspepsia symptoms
pulmonary_dirofilariasis	pulmonary dirofilariasis
uterine_abnormalities	uterine abnormalities
25-oh-vitd	25-oh-vitd
3-omd	3-omd
cdi	cdi
cerebral_ischemic_injury	cerebral ischemic injury
1,25-dhcc	1,25-dhcc
177lu-psma-617	177lu-psma-617
neuroendocrine_tumours	neuroendocrine tumours
1,2,3,6-tetrahydro-n-trichloromethylthiophthalmide	1,2,3,6-tetrahydro-n-trichloromethylthiophthalmide
arteritis	arteritis
vd_deficiency	vd deficiency
aaa	aaa
3h_dihydroergocryptine	3h dihydroergocryptine
missed_abortion	missed abortion
17_alpha-hydroxyprogesterone	17 alpha-hydroxyprogesterone
ovarian_tumors	ovarian tumors
2-methoxy-p-phenylenediamine	2-methoxy-p-phenylenediamine
op	op
neurites	neurites
17-hdha	17-hdha
1-methylisoguanosine	1-methylisoguanosine
4-nerolidylcatechol	4-nerolidylcatechol
bone_impaired_tumour_definition	bone impaired tumour definition
skin_inflammation	skin inflammation
51-cr-edta	51-cr-edta
3,28-bis-hemiphthalate	3,28-bis-hemiphthalate
pain	pain
18f-fluciclovine	18f-fluciclovine
increased_dark_toxicity	increased dark toxicity
1-nitroso-5,6-dihydrouracil	1-nitroso-5,6-dihydrouracil
4-dimethylaminostilbene	4-dimethylaminostilbene
14-o-mem6su	14-o-mem6su
inherited_deficiency	inherited deficiency
cancerous_oral_mucosa	cancerous oral mucosa
endometrial_cancer_hec-1-a	endometrial cancer hec-1-a
5_ala-pdt	5 ala-pdt
glucose_metabolism	glucose metabolism
1_o2	1 o2
gastric_disease	gastric disease
an	an
metabolic_syndrome	metabolic syndrome
ischemic_tolerance	ischemic tolerance
inflammatory_myofibroblastic_tumour	inflammatory myofibroblastic tumour
2-acetylphenol	2-acetylphenol
systemic_sclerosis	systemic sclerosis
17-oh_progesterone	17-oh progesterone
metastatic_lymphoma	metastatic lymphoma
3-sulfogalactocerebroside	3-sulfogalactocerebroside
ventilatory_failure	ventilatory failure
5-aminoimidazole-4-carboxamide_riboside	5-aminoimidazole-4-carboxamide riboside
20-hydroxyecdysterone	20-hydroxyecdysterone
space_motion_sickness	space motion sickness
3d-fiesta	3d-fiesta
traumatic_hemorrhage	traumatic hemorrhage
cognitive_empathy	cognitive empathy
ovarian_tumours	ovarian tumours
neural_crest_tumours	neural crest tumours
pcos	pcos
18f-fluoride	18f-fluoride
4-chloro-19-nortestosterone_acetate	4-chloro-19-nortestosterone acetate
5,6-trans_vitamin_d3	5,6-trans vitamin d3
1,8-cineol	1,8-cineol
2,3-dihydroxybenzoic_acid	2,3-dihydroxybenzoic acid
2-iod	2-iod
4-hydroxybutyrate	4-hydroxybutyrate
5-3_beta-hydroxysteroid	5-3 beta-hydroxysteroid
canadian_health_measures_survey	canadian health measures survey
18f-fp-cit	18f-fp-cit
death_of_brain_dopaminergic_neurons	death of brain dopaminergic neurons
4-phenyl_butyric_acid	4-phenyl butyric acid
1,3-propanediol	1,3-propanediol
adrenocortical	adrenocortical
genetic_damage	genetic damage
2-demethylcolchicine	2-demethylcolchicine
18-fluorodeoxyglucose	18-fluorodeoxyglucose
4-nitroimidazole	4-nitroimidazole
autosomal_recessive_error_of_purine_metabolism	autosomal recessive error of purine metabolism
18-f	18-f
sympathetic_nervous_dysfunction	sympathetic nervous dysfunction
squamous_cell_lung_cancer	squamous cell lung cancer
gallbladder_adenocarcinoma	gallbladder adenocarcinoma
4-hydroxyandrost-4-ene-3,17-dione	4-hydroxyandrost-4-ene-3,17-dione
2,4-dimethoxyphenyl-e-4-arylidene-3-isochromanone	2,4-dimethoxyphenyl-e-4-arylidene-3-isochromanone
hcl	hcl
lems	lems
glycoproteins_in_chronic_myelogenous_leukaemia	glycoproteins in chronic myelogenous leukaemia
papillary_tumors	papillary tumors
paired_pulse_depression	paired pulse depression
3-deazaneplanocin_a	3-deazaneplanocin a
malignant_lymphomas	malignant lymphomas
embryonic_day	embryonic day
chronic_myeloid_leukemia	chronic myeloid leukemia
endometrial_cancer	endometrial cancer
4-methylbenzenecarbothioamide	4-methylbenzenecarbothioamide
temporomandibular_joint	temporomandibular joint
11-oxycorticoids	11-oxycorticoids
leukemias	leukemias
2-arylethyl_4-cyanobenzoates	2-arylethyl 4-cyanobenzoates
anorexia_nervosa	anorexia nervosa
dementia	dementia
12-s-hete	12-s-hete
leukemic	leukemic
trachoma	trachoma
3-4-diaminopyridine	3-4-diaminopyridine
4-abah	4-abah
hypoxic	hypoxic
3-hydroxy-3-methylglutaryl-conenzyme_a	3-hydroxy-3-methylglutaryl-conenzyme a
1alpha-hydroxyimbricatolic_acid	1alpha-hydroxyimbricatolic acid
adrenal_crisis	adrenal crisis
metabolic_dysfunction	metabolic dysfunction
51-cr-chromic-beta-glycerophosphate	51-cr-chromic-beta-glycerophosphate
cerebral_infarct	cerebral infarct
haemorrhage	haemorrhage
4-carboxymethylene-4-sulfo-but-2-en-olide	4-carboxymethylene-4-sulfo-but-2-en-olide
balloon_injury	balloon injury
2ohe2	2ohe2
uterine_leiomyomas	uterine leiomyomas
1-5-hydroxytryptophan	1-5-hydroxytryptophan
3h-25_hydroxyvitamin_d	3h-25 hydroxyvitamin d
5,6-dihydroxytryptamine	5,6-dihydroxytryptamine
17b-estradiol	17b-estradiol
17b-hydroxysteroid	17b-hydroxysteroid
2-polyhydroxyethyl_methacrylate	2-polyhydroxyethyl methacrylate
17-beta-hydroxy-17-alpha-methyl-androstanopyrazole	17-beta-hydroxy-17-alpha-methyl-androstanopyrazole
chronic_cerebral_ischemia	chronic cerebral ischemia
3,11-dimec	3,11-dimec
downbeat_nystagmus	downbeat nystagmus
3_pufas	3 pufas
17-ohp	17-ohp
2,3-diphosphoglycerate	2,3-diphosphoglycerate
intervertebral_disc_degeneration	intervertebral disc degeneration
12-tetradecanoylphorbol-13-acetate	12-tetradecanoylphorbol-13-acetate
vt	vt
bone_diseases	bone diseases
1-methyl-4-phenylpyridine	1-methyl-4-phenylpyridine
2-alkyl-4-quinolones	2-alkyl-4-quinolones
2-arylbenzofurans	2-arylbenzofurans
pineoblastomas	pineoblastomas
diabetic_diarrhoea	diabetic diarrhoea
fungal_growth_reduction	fungal growth reduction
3-deazaadenosine_a	3-deazaadenosine a
haemophilus	haemophilus
2-nitronaphthalene	2-nitronaphthalene
3-asp	3-asp
4-heptanone	4-heptanone
chromosome_aberrations	chromosome aberrations
4e	4e
1,25-vitamin_d3	1,25-vitamin d3
10-methylene_tetrahydrofolate	10-methylene tetrahydrofolate
mycosis_fungoides	mycosis fungoides
bronchial_asthma	bronchial asthma
detoxification_of_environmental_carcinogens	detoxification of environmental carcinogens
laryngeal_papillomatosis	laryngeal papillomatosis
2-oca	2-oca
15-deoxyspergualin	15-deoxyspergualin
1-thc-7-oic_acid	1-thc-7-oic acid
2-phenylindenes	2-phenylindenes
visual-vestibular_stimulation	visual-vestibular stimulation
aneurysms	aneurysms
infected_with_dengue_virus	infected with dengue virus
20-mca	20-mca
diabetic	diabetic
2,3,5-triphenyl_tetrazolium_chloride	2,3,5-triphenyl tetrazolium chloride
3-hydroxykynurenine	3-hydroxykynurenine
4-vinylcyclohexene	4-vinylcyclohexene
4-aminophenols	4-aminophenols
ventral_tegmental_area	ventral tegmental area
myeloproliferative_disorders	myeloproliferative disorders
aids	aids
ulcer	ulcer
1-o-alkyl-2-acetyl-sn-glyceryl-3-phosphorylcholine	1-o-alkyl-2-acetyl-sn-glyceryl-3-phosphorylcholine
mucoepidermoid_carcinoma	mucoepidermoid carcinoma
lymph_node_metastasis	lymph node metastasis
11c-methionine	11c-methionine
pulmonary_and_hepatic_toxicity	pulmonary and hepatic toxicity
neuromuscular_diseases	neuromuscular diseases
17-allylamino-17-demethoxy_geldanamycin	17-allylamino-17-demethoxy geldanamycin
h_after_treatment	h after treatment
4-nitroguinoline-1-oxide	4-nitroguinoline-1-oxide
5_alpha-dihydrotestosterone	5 alpha-dihydrotestosterone
intestinal_amebiasis	intestinal amebiasis
adenovirus_type_5-infected	adenovirus type 5-infected
15-methyl-lxa4	15-methyl-lxa4
photothrombotic_ischemic_injury	photothrombotic ischemic injury
aldosterone_deficiency	aldosterone deficiency
atopic_asthma	atopic asthma
17beta-hydroxysteroid	17beta-hydroxysteroid
colonic_cancer	colonic cancer
14c-glyphosate	14c-glyphosate
prostatic_carcinoma	prostatic carcinoma
2-aminomethylene-17alpha-methyl-17beta-hydroxy-5alpha-androstan-3-one	2-aminomethylene-17alpha-methyl-17beta-hydroxy-5alpha-androstan-3-one
beta-amyloid	beta-amyloid
1,25-d	1,25-d
2-hydroxycaproate	2-hydroxycaproate
microvesicular_fatty_liver	microvesicular fatty liver
5,6,7-trinor-4,8-inter-m-phenylene-pgi2	5,6,7-trinor-4,8-inter-m-phenylene-pgi2
1-phenyl-3-methyl-3-pentanol	1-phenyl-3-methyl-3-pentanol
3h-spiperone	3h-spiperone
allergic_reactions	allergic reactions
allergic_asthma	allergic asthma
liver_disease	liver disease
4-iodoantipyrine	4-iodoantipyrine
21-aminosteroid_u-74006f	21-aminosteroid u-74006f
hypogonadotropic_hypogonadism	hypogonadotropic hypogonadism
mouse_ear_oedema	mouse ear oedema
steatorrhea	steatorrhea
ischemic_damage	ischemic damage
2-f-ara-amp	2-f-ara-amp
3,6-dhf	3,6-dhf
malignant_melanomas	malignant melanomas
5,7-dihydroxyflavone	5,7-dihydroxyflavone
2,4-dinitro-1-fluorobenzene	2,4-dinitro-1-fluorobenzene
glottic_cancer	glottic cancer
18f-2-deoxy-d-glucose	18f-2-deoxy-d-glucose
alpha-l-iduronidase_deficiencies	alpha-l-iduronidase deficiencies
18f-fdopa	18f-fdopa
2-nitroimidazole	2-nitroimidazole
eosinophils	eosinophils
glomerulonephritis	glomerulonephritis
18_f-fdg	18 f-fdg
labor_analgesia	labor analgesia
17a-hydroxyprogesterone_caproate	17a-hydroxyprogesterone caproate
18b-sga	18b-sga
4-hydroxy_estradiol	4-hydroxy estradiol
chronic_active_hepatitis	chronic active hepatitis
1h-csi	1h-csi
hodgkin_lymphoma	hodgkin lymphoma
2-hydroxy-sebacic_acid	2-hydroxy-sebacic acid
2,4,6-triamino-pyridimyl-5-azobenzene	2,4,6-triamino-pyridimyl-5-azobenzene
2-ap5	2-ap5
scn	scn
cvds	cvds
15-f2t-isoprostane	15-f2t-isoprostane
17alpha-ethynylestradiol	17alpha-ethynylestradiol
nen	nen
4-hydroxyanisole	4-hydroxyanisole
2,6-dmnm	2,6-dmnm
24h	24h
healing_inflammation	healing inflammation
18sab075	18sab075
14,15-dhet	14,15-dhet
automaticity	automaticity
chromosomal_aberrations	chromosomal aberrations
18s_rrna	18s rrna
2-hobp	2-hobp
11-dehydro-cs	11-dehydro-cs
18f-flortaucipir	18f-flortaucipir
3a-hydroxymasticadienonic_acid	3a-hydroxymasticadienonic acid
15-methylprostaglandin_f2_alpha	15-methylprostaglandin f2 alpha
1,10-phenantroline	1,10-phenantroline
autosomal_recessive_defect	autosomal recessive defect
endothelial_injury	endothelial injury
1-methoxyoctadecan-1-ol	1-methoxyoctadecan-1-ol
3-slp	3-slp
12-deoxyphorbol_13-esters	12-deoxyphorbol 13-esters
1ctp	1ctp
18-fluoro-deoxyglucose	18-fluoro-deoxyglucose
4d3	4d3
25ohd	25ohd
flame_retardant	flame retardant
4-thiouridine	4-thiouridine
neuronal_loss	neuronal loss
5,12-dimethylchrysene	5,12-dimethylchrysene
3-methoxynaltrexone	3-methoxynaltrexone
allergic_rashes	allergic rashes
3,4-methylenedioxyamphetamine	3,4-methylenedioxyamphetamine
csds	csds
1h3	1h3
anorexia	anorexia
3-ctv	3-ctv
2-hexylidene_cyclopentanone	2-hexylidene cyclopentanone
interstitial_lung_disease	interstitial lung disease
2,3-diamino-2,3-dideoxy-d-glucose_disaccharide_phosphomonoester	2,3-diamino-2,3-dideoxy-d-glucose disaccharide phosphomonoester
wall_motion_abnormalities	wall motion abnormalities
autoimmune_disease	autoimmune disease
2-nbdg	2-nbdg
nhl	nhl
lipoproteinemia	lipoproteinemia
myocardial_infarction	myocardial infarction
non-alcoholic_fatty_liver_disease	non-alcoholic fatty liver disease
ali	ali
granulomatous_lung_diseases	granulomatous lung diseases
melanosis	melanosis
3-methyllexitropsin	3-methyllexitropsin
thalassemia	thalassemia
oral_cancer	oral cancer
b-cell_chronic_lymphocytic_leukemia	b-cell chronic lymphocytic leukemia
ascites_tumor	ascites tumor
acute_cardiac_insufficiency	acute cardiac insufficiency
post-column_derivatization	post-column derivatization
mes	mes
hypercapnia	hypercapnia
primary_tumors	primary tumors
alveolar	alveolar
2,3,5-triphenyl-2h-tetrazolium_chloride	2,3,5-triphenyl-2h-tetrazolium chloride
vitiligo	vitiligo
2-methylpiperazine	2-methylpiperazine
20_acid	20 acid
-3_fatty_acids	-3 fatty acids
congenital_heart_diseases	congenital heart diseases
5,5-diphenylhydantoin	5,5-diphenylhydantoin
18-fluorodeoxyglucose_positron	18-fluorodeoxyglucose positron
3nap	3nap
sickle-cell_disease	sickle-cell disease
lymphoma	lymphoma
3np	3np
18alpha-ga	18alpha-ga
18f-fedac	18f-fedac
2-3_di-phosphoglycerate	2-3 di-phosphoglycerate
yoshida_sarcoma	yoshida sarcoma
17-ks	17-ks
1,25-d3	1,25-d3
brain_tumours	brain tumours
uterine_rupture	uterine rupture
11-dehydrosinulariolide	11-dehydrosinulariolide
bone_deterioration	bone deterioration
myocardial_ischemia	myocardial ischemia
5-arylpyrimidines	5-arylpyrimidines
lung_inflammation	lung inflammation
contralateral_rotation	contralateral rotation
3-n-alkyloxyestradiol	3-n-alkyloxyestradiol
gs	gs
3-aryl-1h-quinolin-4-ones	3-aryl-1h-quinolin-4-ones
respiratory_tract_infection	respiratory tract infection
taxus_poisoning	taxus poisoning
18f-fluorodihydroxyphenylalanine	18f-fluorodihydroxyphenylalanine
1r,6s-amine	1r,6s-amine
macroglobulinaemia	macroglobulinaemia
2-chlorofatty_acids	2-chlorofatty acids
1-deoxysphingoid	1-deoxysphingoid
5,10-methylenetetrahydrofolate	5,10-methylenetetrahydrofolate
123i_metaiodobenzylguanidine	123i metaiodobenzylguanidine
skin_diseases	skin diseases
sarcomas	sarcomas
brain_failures	brain failures
muscle_damage	muscle damage
injury_in_rabbit_lungs	injury in rabbit lungs
empyema_thoracis	empyema thoracis
4-hydroxybenzyl_alcohol	4-hydroxybenzyl alcohol
4-oh-ile	4-oh-ile
b-cll	b-cll
2-chloroethyl_ethyl_sulfide	2-chloroethyl ethyl sulfide
panic_disorder	panic disorder
3-du	3-du
estrus_and_viable_embryo_number	estrus and viable embryo number
adrenal_failure	adrenal failure
4-phenylpyridine	4-phenylpyridine
4-mercaptobenzoic_acid	4-mercaptobenzoic acid
mimt	mimt
13c-phenylalanine	13c-phenylalanine
atl	atl
add	add
1,4-benzenedithiol	1,4-benzenedithiol
acute_liver_injury	acute liver injury
14-c	14-c
methicillin-resistant_staphylococcus_aureus	methicillin-resistant staphylococcus aureus
diabetic_periodontitis	diabetic periodontitis
3-hydroxy-4-keto-carotenoids	3-hydroxy-4-keto-carotenoids
17ohp	17ohp
ca	ca
2-bromoethylamine	2-bromoethylamine
2-thio-pyrimidine_nucleoside	2-thio-pyrimidine nucleoside
1,9-diphenyl-9h-fluorene	1,9-diphenyl-9h-fluorene
metabolic_disorder	metabolic disorder
bile_duct_cancer	bile duct cancer
cardiomyocyte_anomalies	cardiomyocyte anomalies
hypoxic_brain_injury	hypoxic brain injury
cleft_palate	cleft palate
4beta-phorbol_12-myristate	4beta-phorbol 12-myristate
protein_palmitoylation	protein palmitoylation
2-a-dnt	2-a-dnt
3-hydroxyisovaleric_acid	3-hydroxyisovaleric acid
colorectal_carcinoma	colorectal carcinoma
choline-deficient	choline-deficient
brain_infarction	brain infarction
1-alpha-hydroxyvitamin_d3	1-alpha-hydroxyvitamin d3
1,3-dipropyl-8-sulfophenylxanthine	1,3-dipropyl-8-sulfophenylxanthine
2-bromoterguride	2-bromoterguride
spinal_meningioma	spinal meningioma
1-b-d-arabinofuranosylcytosine	1-b-d-arabinofuranosylcytosine
water_emulsion	water emulsion
meningiomas	meningiomas
2h-chromen-2-one	2h-chromen-2-one
188re-mag2-rgd-bombesin	188re-mag2-rgd-bombesin
tumours	tumours
coronary_heart_disease	coronary heart disease
amelanotic_tumours	amelanotic tumours
13c-bicarbonate	13c-bicarbonate
toxicity	toxicity
2-ox	2-ox
2-aa	2-aa
rt	rt
hob	hob
mcf-7_and_mda-mb-231_breast_cancer	mcf-7 and mda-mb-231 breast cancer
ar	ar
injury_of_liver	injury of liver
hepatic_glucose_production	hepatic glucose production
basal_cell_carcinomas	basal cell carcinomas
nausea	nausea
painful_skeletal_metastases	painful skeletal metastases
1,25-oh2d	1,25-oh2d
51cr-labeled_edta	51cr-labeled edta
4-hydroxytamoxifen	4-hydroxytamoxifen
hypoglycemia	hypoglycemia
4-epirubicin	4-epirubicin
cholangiocarcinoma	cholangiocarcinoma
chronic_inflammatory_bowel_disease	chronic inflammatory bowel disease
sinus_slowing	sinus slowing
16alpha-bromoepiandrosterone	16alpha-bromoepiandrosterone
tumoral_calcinosis	tumoral calcinosis
3h-cyclic-amp	3h-cyclic-amp
vertebral_fractures	vertebral fractures
1,4-bd	1,4-bd
seizures	seizures
4-methoxy-2,2,6,6-tetramethylpiperidine-n-oxyl	4-methoxy-2,2,6,6-tetramethylpiperidine-n-oxyl
153sm-nta	153sm-nta
5alpha-pregnan-3alpha-ol-20-one	5alpha-pregnan-3alpha-ol-20-one
triple-negative_breast_cancer	triple-negative breast cancer
1,2-diacylglycerol	1,2-diacylglycerol
4-pentenoic_acid	4-pentenoic acid
188re-mag3-depreotide	188re-mag3-depreotide
t-cell_dysfunction	t-cell dysfunction
testicular_damage	testicular damage
reye_like_syndrome	reye like syndrome
1,25-dihydroxycholecalciferol	1,25-dihydroxycholecalciferol
chronic_lymphocytic_leukemia	chronic lymphocytic leukemia
2-hg	2-hg
breast_leiomyosarcoma	breast leiomyosarcoma
17-hydroxycorticosteroids	17-hydroxycorticosteroids
3-port	3-port
spns	spns
renal_insufficiency	renal insufficiency
swelling	swelling
subacute_thyroiditis	subacute thyroiditis
inflammatory_oedema	inflammatory oedema
4-nitroestrone_3-methyl_ether	4-nitroestrone 3-methyl ether
4-nitroquinoline_1-oxide	4-nitroquinoline 1-oxide
coronary_dysfunction	coronary dysfunction
rf	rf
actinic_keratosis	actinic keratosis
pleuritis	pleuritis
1-methyl-1-androstenolone	1-methyl-1-androstenolone
liver_and_kidney_damage	liver and kidney damage
14c-amino_acids	14c-amino acids
heparin-induced_thrombocytopenia	heparin-induced thrombocytopenia
071031b	071031b
12-o-tetradecanoyl_phorbol-13_acetate	12-o-tetradecanoyl phorbol-13 acetate
2,3,5-triphenyltetrazolium_chloride	2,3,5-triphenyltetrazolium chloride
metabolic_impairment	metabolic impairment
fatal_anaphylactoid_reaction	fatal anaphylactoid reaction
coronary_artery_occlusion	coronary artery occlusion
1-bp	1-bp
4-biphenylacetic_acid	4-biphenylacetic acid
extrapyramidal_syndrome	extrapyramidal syndrome
15_d-pgj2	15 d-pgj2
axonal_neuropathy	axonal neuropathy
4-hw	4-hw
head_circumference	head circumference
t-nhl	t-nhl
infarction	infarction
2,4-diaryloxazoles	2,4-diaryloxazoles
dcm	dcm
4-aroyl-1,5-disubstituted-3-hydroxy-2h-pyrrol-2-one	4-aroyl-1,5-disubstituted-3-hydroxy-2h-pyrrol-2-one
1-octen-3-ol	1-octen-3-ol
13-hpotre	13-hpotre
lymphomas	lymphomas
19-o-methylpelorol	19-o-methylpelorol
motor_deficit	motor deficit
5,6-dihydro-5-azathymidine	5,6-dihydro-5-azathymidine
actinic_keratoses	actinic keratoses
mhs	mhs
atypical_acinar_cell_lesions_of_the_pancreas	atypical acinar cell lesions of the pancreas
5-androstenediol	5-androstenediol
25-oh_vitd	25-oh vitd
myxedema	myxedema
miscarriages	miscarriages
3-n-alkyphthalide	3-n-alkyphthalide
bone_marrow_failure	bone marrow failure
mouse_ehrlich_ascites_tumor	mouse ehrlich ascites tumor
3,5-cyclic_adenosine_monophosphate	3,5-cyclic adenosine monophosphate
xy_dsd	xy dsd
1-tert-butyl-6-cyano-1,2,3,4-tetrahydroquinoline	1-tert-butyl-6-cyano-1,2,3,4-tetrahydroquinoline
adjuvant_induced_arthritis	adjuvant induced arthritis
3-month_l-arginine	3-month l-arginine
parkinsonism	parkinsonism
colorectal_neoplasia	colorectal neoplasia
idiopathic_hirsutism	idiopathic hirsutism
3-hydroxy-3-methyl-glutaryl-coenzyme-a	3-hydroxy-3-methyl-glutaryl-coenzyme-a
chemical_vapor_deposition	chemical vapor deposition
nash	nash
13-acetate	13-acetate
2-substituted_dipyridodiazepinones	2-substituted dipyridodiazepinones
3h-na	3h-na
chronic_granulocytic_leukemia	chronic granulocytic leukemia
mouse_lymphoma	mouse lymphoma
1,2-epoxybutene-3	1,2-epoxybutene-3
4fe4s	4fe4s
1-palmitoyl-2-oleoyl-sn-glycero-3-phosphocholine	1-palmitoyl-2-oleoyl-sn-glycero-3-phosphocholine
5-aminoimidazole-4-carboxamide-1-beta-d-ribofuranoside	5-aminoimidazole-4-carboxamide-1-beta-d-ribofuranoside
hyperthyroid	hyperthyroid
targeting_cancer	targeting cancer
electron-deficient_allenes_also	electron-deficient allenes also
diffuse_vascular_spasm	diffuse vascular spasm
18f-fluoro-deoxyglucose	18f-fluoro-deoxyglucose
deep-wound_infection	deep-wound infection
eosinophilia-myalgia_syndrome	eosinophilia-myalgia syndrome
von_willebrand_disease	von willebrand disease
2,4,6-trinitrobenzene_sulfonic	2,4,6-trinitrobenzene sulfonic
prostate_tumors	prostate tumors
calcification	calcification
epileptiform_bursting	epileptiform bursting
rosacea	rosacea
hypertensive	hypertensive
fatal_familial_insomnia	fatal familial insomnia
1,4-cyclohexanecarboxylates	1,4-cyclohexanecarboxylates
acute_myelogenous_leukemia	acute myelogenous leukemia
2-o-tetradecanoylphorbol_13-acetate	2-o-tetradecanoylphorbol 13-acetate
4-methylumbelliferyl	4-methylumbelliferyl
metastatic_tumor	metastatic tumor
4-hba	4-hba
myocardial_viability	myocardial viability
motor_impairments	motor impairments
4-me	4-me
13c-acetate	13c-acetate
hormone-refractory_prostate_cancer	hormone-refractory prostate cancer
3h-gaba	3h-gaba
facial_flat_wart	facial flat wart
3mga	3mga
12-o-tetradecaoylphorbol-13-acetate	12-o-tetradecaoylphorbol-13-acetate
hyperphagia	hyperphagia
17_a-hydroxyprogesterone_caproate	17 a-hydroxyprogesterone caproate
gastric_mucinous_cancer	gastric mucinous cancer
3_hydroxyacyl	3 hydroxyacyl
4-bromo-2,5-dimethoxyphenethylamine	4-bromo-2,5-dimethoxyphenethylamine
autoimmune_type_1_diabetes	autoimmune type 1 diabetes
4-nitroquinoline-1-oxide	4-nitroquinoline-1-oxide
3-isobutyl-methyl-xanthine	3-isobutyl-methyl-xanthine
neuropsychic_agitation	neuropsychic agitation
chemotaxis	chemotaxis
3-fc	3-fc
renal_tumors	renal tumors
carnitine_palmitoyltransferase_i	carnitine palmitoyltransferase i
diseases_of_the_colon	diseases of the colon
3-deoxy-7,8-dihydromorphine	3-deoxy-7,8-dihydromorphine
radical_damage	radical damage
5,8,11,14-eicosatetraenoic_acid	5,8,11,14-eicosatetraenoic acid
3-cyano-2-substituted_pyridines	3-cyano-2-substituted pyridines
3-hydroxy-3-methyl-glutaryl-coa	3-hydroxy-3-methyl-glutaryl-coa
mrd	mrd
2-amino-5-phosphono-valeric_acid	2-amino-5-phosphono-valeric acid
1-ethyl-2-benzimidazolinone	1-ethyl-2-benzimidazolinone
18f-fluorodeoxyglucose_positron	18f-fluorodeoxyglucose positron
12-0-tetradecanoylphorbol	12-0-tetradecanoylphorbol
17-40s	17-40s
4-ipc	4-ipc
adrenal_insufficiency	adrenal insufficiency
3-methoxy-4-hydroxyphenylglycol	3-methoxy-4-hydroxyphenylglycol
hypercholesterolemia	hypercholesterolemia
3h-betaxolol	3h-betaxolol
aging	aging
3-methoxy-4-hydroxyphenyl_glycol	3-methoxy-4-hydroxyphenyl glycol
sln	sln
3-hmx	3-hmx
pancreatic_fistulas	pancreatic fistulas
1a-hydroxycholecalciferol	1a-hydroxycholecalciferol
primary_hypothyroidism	primary hypothyroidism
bladder_carcinogens	bladder carcinogens
ndps	ndps
skin_cancer	skin cancer
manic-depressive_illness	manic-depressive illness
1e3mim	1e3mim
3,5-t2	3,5-t2
bladder_transitional_cell_cancers	bladder transitional cell cancers
epidermoid_carcinoma	epidermoid carcinoma
pulmonary_lesions	pulmonary lesions
3-azido-2,3-dideoxythymidine	3-azido-2,3-dideoxythymidine
3-ohba	3-ohba
3bp	3bp
3-hydroxy-3-methylglutaryl-coenzyme_a	3-hydroxy-3-methylglutaryl-coenzyme a
12-o-tetradecanoylphorbol_acetate	12-o-tetradecanoylphorbol acetate
2h5-glycerol	2h5-glycerol
5-aminoimidazole-4-carboxamide_ribonucleoside	5-aminoimidazole-4-carboxamide ribonucleoside
131-meta-iodo-benzylguanidine	131-meta-iodo-benzylguanidine
2-o-acetyllycorine	2-o-acetyllycorine
1.2-dichloropropane	1.2-dichloropropane
csu	csu
hts	hts
alveolar_damage	alveolar damage
dka	dka
parkinsonian	parkinsonian
3,4-dge	3,4-dge
malformation	malformation
18f-fdg_pet	18f-fdg pet
chronic_liver_disease	chronic liver disease
3,4-dichloropropionaniline	3,4-dichloropropionaniline
complete_disappearance_of_the_tumour	complete disappearance of the tumour
1-appn	1-appn
propionic_acidaemia	propionic acidaemia
experimental_allergic_encephalomyelitis	experimental allergic encephalomyelitis
atrophy_of_uterus	atrophy of uterus
ls_bmd_gains	ls bmd gains
tree-top_disease	tree-top disease
splenic_vein_obstruction	splenic vein obstruction
1,2,3,4-tetrahydroisoquinoline-3-carboxylic_acid	1,2,3,4-tetrahydroisoquinoline-3-carboxylic acid
18f-fdg_positron	18f-fdg positron
hnscc	hnscc
2-mx	2-mx
17d-204	17d-204
bladder_cancer	bladder cancer
chs	chs
adult_worms	adult worms
neoplastic_disease	neoplastic disease
breast_cancer_and_melanoma	breast cancer and melanoma
enteric_serotonergic_neurons	enteric serotonergic neurons
3,5-dibromosalicylaldehyde	3,5-dibromosalicylaldehyde
21-oh_germline	21-oh germline
tumor	tumor
1.2-diacylglycerol	1.2-diacylglycerol
27ohc	27ohc
17-hydroxysteroid	17-hydroxysteroid
hyperlipidemia	hyperlipidemia
dental_abnormalities	dental abnormalities
18-oh-b	18-oh-b
1,2-octanediol	1,2-octanediol
3,5-diethoxycarbonyl-1,4-dihydrocollidine	3,5-diethoxycarbonyl-1,4-dihydrocollidine
1,2-epoxy-3-butene	1,2-epoxy-3-butene
cse	cse
pp	pp
lymphocytopenia	lymphocytopenia
15-hydroperoxyeicosatetraenoic_acid	15-hydroperoxyeicosatetraenoic acid
osteolytic_lesions	osteolytic lesions
muscle_relaxation	muscle relaxation
15d-pgj	15d-pgj
2-naphthoyl_sit_ester	2-naphthoyl sit ester
1-phenyl-2-dimethylamino-ethoxymethyl_tetrazole_hydrochloride	1-phenyl-2-dimethylamino-ethoxymethyl tetrazole hydrochloride
muscle_rigidity	muscle rigidity
3-diphosphoglycerate	3-diphosphoglycerate
3-hydroxy-3-methylglutaric_aciduria	3-hydroxy-3-methylglutaric aciduria
alveolitis	alveolitis
3-dcrt	3-dcrt
methylmalonic_and_propionic_acidemias	methylmalonic and propionic acidemias
atrial_slices	atrial slices
colon_cancers	colon cancers
mas	mas
131_i-metaiodobenzylguanidine	131 i-metaiodobenzylguanidine
3-oh-butyrate	3-oh-butyrate
occupational_allergic_contact_dermatitis	occupational allergic contact dermatitis
dm	dm
hae	hae
20-methylcholantrene	20-methylcholantrene
lower_cytotoxicity	lower cytotoxicity
12,13-epoxytrichothecenes	12,13-epoxytrichothecenes
ssc	ssc
2-mercaptoethylguanidine	2-mercaptoethylguanidine
idiopathic_hypoparathyroidism	idiopathic hypoparathyroidism
grape_seed_extract	grape seed extract
2,3,6-triaminopyridine	2,3,6-triaminopyridine
4-quinolones	4-quinolones
oligodendrocyte_cell_death	oligodendrocyte cell death
2,3-dihydroxy-6-nitro-7-sulfamoyl-benzoquinoxaline-2,3-dione	2,3-dihydroxy-6-nitro-7-sulfamoyl-benzoquinoxaline-2,3-dione
differentiated_thyroid_cancer	differentiated thyroid cancer
17-ohp-c	17-ohp-c
ischaemic_brain_injury	ischaemic brain injury
rectal_cancer	rectal cancer
3h-imipramine	3h-imipramine
15au81	15au81
mastocytosis	mastocytosis
19-nortestosterone	19-nortestosterone
3,6-dideoxyhexose	3,6-dideoxyhexose
17_alpha_ethinyl_estriol	17 alpha ethinyl estriol
4-o-pentyl-gabosine_d	4-o-pentyl-gabosine d
3-hydroxyproline	3-hydroxyproline
2-methoxyestrone	2-methoxyestrone
dd	dd
cutaneous_leishmaniasis	cutaneous leishmaniasis
2,3_diamino-phenazine	2,3 diamino-phenazine
4-pyridoxic_acid	4-pyridoxic acid
haemorrhagic_shock	haemorrhagic shock
14c-acetate	14c-acetate
15f-2t-isoprostane	15f-2t-isoprostane
sebaceous_hyperplasia	sebaceous hyperplasia
4sc-202	4sc-202
left-sided_ulcerative_colitis	left-sided ulcerative colitis
15-keto-13,14-dihydro-prostaglandin_f2alpha	15-keto-13,14-dihydro-prostaglandin f2alpha
18f-flt	18f-flt
rpcs	rpcs
3ntyr	3ntyr
25-hydroxyvitamin-d3	25-hydroxyvitamin-d3
iddm	iddm
11-ocs	11-ocs
1-cyproterone_acetate	1-cyproterone acetate
12-hydroxyeicosatetraenoic_acid	12-hydroxyeicosatetraenoic acid
alopecia	alopecia
squamous_cell_carcinoma	squamous cell carcinoma
tremor	tremor
3,4_metylenedioxymethamphetamine	3,4 metylenedioxymethamphetamine
hypophosphatemic_rickets	hypophosphatemic rickets
213bi-dotatoc	213bi-dotatoc
111-indium-octreotide	111-indium-octreotide
3-caffeoylquinic_acid	3-caffeoylquinic acid
13-cis_ra	13-cis ra
neuronal_death	neuronal death
paralysis	paralysis
premature_adrenarche	premature adrenarche
tumor-vascular_disrupting	tumor-vascular disrupting
20-hydroxyeicosatetraeonic_acid	20-hydroxyeicosatetraeonic acid
nephrotic_syndrome	nephrotic syndrome
5-ari	5-ari
3-aminopropylsiloxane	3-aminopropylsiloxane
25-oh-cholecalciferol	25-oh-cholecalciferol
3,4-dihydroxyphenylacetic_and_homovanillic_acid	3,4-dihydroxyphenylacetic and homovanillic acid
increases_in_renal_protein_carbonyls	increases in renal protein carbonyls
plasma_cholinesterase_deficiency	plasma cholinesterase deficiency
graft_versus_host_disease	graft versus host disease
inhibition_of_n-linked_glycosylation	inhibition of n-linked glycosylation
2-methoxyindole-2-carboxylic_acid	2-methoxyindole-2-carboxylic acid
3-hydroxy-3-ethylglutaric_acid	3-hydroxy-3-ethylglutaric acid
pulmonary_squamous_cell_carcinoma	pulmonary squamous cell carcinoma
dystrophic_mitochondria	dystrophic mitochondria
pituitary_diabetes_insipidus	pituitary diabetes insipidus
reactive_oxygen_species_production	reactive oxygen species production
3-phenylpropyl_cinnamate	3-phenylpropyl cinnamate
arterial_inflammation	arterial inflammation
1,2-dichlorobenzene	1,2-dichlorobenzene
21-aminosteroid	21-aminosteroid
neurological_deterioration	neurological deterioration
3-omg	3-omg
acc	acc
3-o-methyldopa	3-o-methyldopa
17-beta-estradiol	17-beta-estradiol
4-nitrophenol	4-nitrophenol
hereditary_spherocytosis_and_sickle_cell_disease	hereditary spherocytosis and sickle cell disease
thrombus	thrombus
123i-imz	123i-imz
1-deamino-8-d-arginine-vasopressin	1-deamino-8-d-arginine-vasopressin
2-decarboxybetanin	2-decarboxybetanin
1-o-octadecyl-2-o-methyl-sn-glycerol-3-phosphocholine	1-o-octadecyl-2-o-methyl-sn-glycerol-3-phosphocholine
4-mc	4-mc
rauscher_leukemia	rauscher leukemia
a549_lung_cancer	a549 lung cancer
alzheimer_disease	alzheimer disease
1h-mrsi	1h-mrsi
malignancy_of_adrenocortical_tumours	malignancy of adrenocortical tumours
3-alpha-androstanediol	3-alpha-androstanediol
diabetes	diabetes
4-np	4-np
4-azido-2-nitrophenyluridylylpyrophosphate	4-azido-2-nitrophenyluridylylpyrophosphate
15n_glycine	15n glycine
3-angelate	3-angelate
12-o-tetradecanoylphorbol13-acetate	12-o-tetradecanoylphorbol13-acetate
3-methyladenine	3-methyladenine
unilateral_renal_artery_stenosis	unilateral renal artery stenosis
melanoma_cancer	melanoma cancer
genital_herpes_infections	genital herpes infections
2-deoxyglucose	2-deoxyglucose
gastric_carcinoma	gastric carcinoma
2-d08	2-d08
1,25_oh_vitamin_d	1,25 oh vitamin d
medullary_thyroid_carcinoma	medullary thyroid carcinoma
map	map
blood_loss	blood loss
1,25-hydroxyvitamin_d3	1,25-hydroxyvitamin d3
polar_auxin_transport	polar auxin transport
4-oxo_ra	4-oxo ra
glutethimide_poisoning	glutethimide poisoning
non-small-cell_lung_cancer	non-small-cell lung cancer
c6_glioma	c6 glioma
nonhematologic_malignancies	nonhematologic malignancies
2-thiophenytoin	2-thiophenytoin
ulcerative_colitis	ulcerative colitis
neuropathic_pains	neuropathic pains
staphylococcus_aureus_osteomyelitis	staphylococcus aureus osteomyelitis
123i-mibg	123i-mibg
pbc	pbc
glutaryl-coa_dehydrogenase_deficiency	glutaryl-coa dehydrogenase deficiency
137cs_burden	137cs burden
17-phenyl-omega-trinor-pge2	17-phenyl-omega-trinor-pge2
vestibular_neuritis	vestibular neuritis
17-desoxymethasone	17-desoxymethasone
diabetic_glomerulonephritis	diabetic glomerulonephritis
neuromuscular_weakness	neuromuscular weakness
1-o-pentylglycerol	1-o-pentylglycerol
peritoneal_dialysis	peritoneal dialysis
leukemia	leukemia
3-nt	3-nt
2-methoxy-5-amino-n-hydroxybenzamide	2-methoxy-5-amino-n-hydroxybenzamide
neuromuscular_blockade	neuromuscular blockade
4-cl-a	4-cl-a
contact_toxicity	contact toxicity
brain_tumors	brain tumors
3-deazaguanosine	3-deazaguanosine
kidney_disease	kidney disease
leydig_cells_hyperplasia	leydig cells hyperplasia
vf	vf
photodynamic_diagnosis	photodynamic diagnosis
fid	fid
4-a-rhamnopyranosyloxy-benzyl_glucosinolate	4-a-rhamnopyranosyloxy-benzyl glucosinolate
4-chloro-2-butynyl_m-chlorocarbanilate	4-chloro-2-butynyl m-chlorocarbanilate
4-hydroxy-5,7-dimethoxycoumarin	4-hydroxy-5,7-dimethoxycoumarin
13-ra	13-ra
3-aryl-2-propenoates	3-aryl-2-propenoates
2-methoxy_isobutyl_isonitrile	2-methoxy isobutyl isonitrile
marrow_disease	marrow disease
human_immunodeficiency_virus-associated_lipodystrophy	human immunodeficiency virus-associated lipodystrophy
renal_damage	renal damage
5a-dht	5a-dht
18f-flutemetamol	18f-flutemetamol
2-octyl_cyanoacrylate	2-octyl cyanoacrylate
decrease_in_the_number_of_swollen_and_tender_joints	decrease in the number of swollen and tender joints
diarrhea	diarrhea
breast_tumor	breast tumor
1-methyl-1-nitrosourea	1-methyl-1-nitrosourea
cutaneous_hypersensitivity_reaction	cutaneous hypersensitivity reaction
ac-isomers-gs	ac-isomers-gs
bladder_contractions	bladder contractions
1-n-naphthylphthalamic_acid	1-n-naphthylphthalamic acid
anxiety_disorders	anxiety disorders
hela	hela
3,3,14,14-tetramethylhexadecanedioic_acid	3,3,14,14-tetramethylhexadecanedioic acid
18f-fluorodeoxyglucose-pet	18f-fluorodeoxyglucose-pet
4-methylmethcathinone	4-methylmethcathinone
melanotic_melanoma	melanotic melanoma
1,6-diphenyl-1,3,5-hexatriene	1,6-diphenyl-1,3,5-hexatriene
intracranial_tuberculomas	intracranial tuberculomas
aa	aa
5-aa-cdr	5-aa-cdr
psoriasis	psoriasis
ht	ht
5alpha,3alpha-p	5alpha,3alpha-p
acute_myeloid_leukemia	acute myeloid leukemia
123i-tyr3-octreotide	123i-tyr3-octreotide
asfv	asfv
early_failure	early failure
3-hyp	3-hyp
cerebellar_in	cerebellar in
3-nitro	3-nitro
123i-imp	123i-imp
double_negative	double negative
retinoblastoma	retinoblastoma
4,5-dihydro-3-phenyl-5-isoxasole_acetic_acid	4,5-dihydro-3-phenyl-5-isoxasole acetic acid
4-diethylaminobenzal-dehyde	4-diethylaminobenzal-dehyde
2-methyl-epa	2-methyl-epa
131i-metaiodobenzylguanidine	131i-metaiodobenzylguanidine
pd_symptoms	pd symptoms
11b-hydroxylase_deficiency	11b-hydroxylase deficiency
3-amino-1,2,4-triazole	3-amino-1,2,4-triazole
celiac_disease	celiac disease
1alpha-hydroxyvitamin_d2	1alpha-hydroxyvitamin d2
x-linked_hypophosphatemia	x-linked hypophosphatemia
colon_adenocarcinomas	colon adenocarcinomas
seminal_t	seminal t
schizophrenia	schizophrenia
oral_cancer_model_system	oral cancer model system
2-amino-2-methyl-1-tetralone	2-amino-2-methyl-1-tetralone
mmm	mmm
4-hydroxynonenal	4-hydroxynonenal
1,10-phenanthroline	1,10-phenanthroline
4-hydroperoxy-cyclophosphamide	4-hydroperoxy-cyclophosphamide
t-cell_prolymphocytic_leukemia	t-cell prolymphocytic leukemia
22,23-dihydroxystigmastane	22,23-dihydroxystigmastane
precancerous_lesions	precancerous lesions
1-methyl-4-phenyl-1,2,3,6-tetrathydropyridine	1-methyl-4-phenyl-1,2,3,6-tetrathydropyridine
1-oleoyl-acetyl-sn-glycerol	1-oleoyl-acetyl-sn-glycerol
1,2,3,6-methyl-phenyl-tetrahydropyridine	1,2,3,6-methyl-phenyl-tetrahydropyridine
chagas_disease	chagas disease
111-indium_dtpa_octreotide	111-indium dtpa octreotide
hbv_infection	hbv infection
fh	fh
babesia	babesia
intrahepatic_cholangiocarcinoma	intrahepatic cholangiocarcinoma
4-hydroxybutyl-butylnitrosamine	4-hydroxybutyl-butylnitrosamine
upper_urinary_tract_urothelial_cancers	upper urinary tract urothelial cancers
3-deazaadenosine	3-deazaadenosine
thyroid_cancer	thyroid cancer
death	death
psp-ns	psp-ns
experimental_dry_eye	experimental dry eye
2-phenoxyethyl_ester	2-phenoxyethyl ester
syd	syd
dopaminergic_neurite_degeneration	dopaminergic neurite degeneration
11,12-epoxyeicosatrienoic_acid	11,12-epoxyeicosatrienoic acid
3-4,5_dimethylthiazol-2,5_diphenyl_tetrazolium_bromide	3-4,5 dimethylthiazol-2,5 diphenyl tetrazolium bromide
allergic_rhinoconjunctivitis	allergic rhinoconjunctivitis
3-hexen-1-ol	3-hexen-1-ol
urethral_adenocarcinoma	urethral adenocarcinoma
2,3-dinor-txb2	2,3-dinor-txb2
fgs	fgs
von_willebrand	von willebrand
depressive_episode	depressive episode
skin_lesions	skin lesions
1-methiq	1-methiq
21-oh_ab	21-oh ab
11beta-hydroxysteroid	11beta-hydroxysteroid
advanced-stage_prostate_cancer	advanced-stage prostate cancer
3h-leucine	3h-leucine
crystallographic_disorder	crystallographic disorder
5-arylazopyrimidines	5-arylazopyrimidines
1-beta-d-arabinofuranosyl-cytosine	1-beta-d-arabinofuranosyl-cytosine
15-epi-lipoxin_a4	15-epi-lipoxin a4
19-nor-doc	19-nor-doc
1-bromopropane	1-bromopropane
urolithiasis	urolithiasis
ovarian_malignancy	ovarian malignancy
2,4-diamino-6-hydroxy-pyrimidine	2,4-diamino-6-hydroxy-pyrimidine
2sc	2sc
2-5_oligoadenylate	2-5 oligoadenylate
injury_in_rabbit_kits	injury in rabbit kits
2dd	2dd
t1d	t1d
2_bd	2 bd
1-hydroxyethylidene-1,1-bisphosphonate	1-hydroxyethylidene-1,1-bisphosphonate
blood_hyperviscosity_syndrome	blood hyperviscosity syndrome
18f-av1451	18f-av1451
rickets_type_i	rickets type i
chromosomal_instability	chromosomal instability
mh	mh
4-aaqb	4-aaqb
pulmonary_malignancy	pulmonary malignancy
liver_carcinogenesis	liver carcinogenesis
1-aminonaphtalene	1-aminonaphtalene
5,10_methylenetetrahydrofolic_acid	5,10 methylenetetrahydrofolic acid
leukocytosis	leukocytosis
4-epi-doxorubicin	4-epi-doxorubicin
histiocytic_sarcoma	histiocytic sarcoma
fabry_disease	fabry disease
lung_adenocarcinoma	lung adenocarcinoma
hplc-icp-ms	hplc-icp-ms
depressor	depressor
131i	131i
mody	mody
male_infertility	male infertility
abrogates_tumor	abrogates tumor
1-methyl_mb	1-methyl mb
1-deoxysphinganine	1-deoxysphinganine
neurologic_disorders	neurologic disorders
juvenile_dermatomyositis	juvenile dermatomyositis
eoc	eoc
1-stearoyl-sn-glycero-3-phosphocholine	1-stearoyl-sn-glycero-3-phosphocholine
2,5-dimercapto-1,3,4-thiadiazole	2,5-dimercapto-1,3,4-thiadiazole
1,8-cineole	1,8-cineole
colonic_carcinoma	colonic carcinoma
17-hydroxy-corticosteroid	17-hydroxy-corticosteroid
111in-pentetreotide	111in-pentetreotide
traumatic_brain_injury	traumatic brain injury
amebiasis	amebiasis
immaturity	immaturity
dehydration	dehydration
1-npz	1-npz
3-hydroxypropionic_aldehyde	3-hydroxypropionic aldehyde
21-aminosteroid_u74006f	21-aminosteroid u74006f
3d-ce-pdu	3d-ce-pdu
shb-emia	shb-emia
tic_disorders	tic disorders
2,4-dinitrobenzenesulfonic_acid	2,4-dinitrobenzenesulfonic acid
retinal_injury	retinal injury
3-aminohexahydrocoumarin	3-aminohexahydrocoumarin
glioblastoma_multiforme	glioblastoma multiforme
osteoporosis	osteoporosis
cca	cca
17-hydroxyprogesterone	17-hydroxyprogesterone
malignant_tumors	malignant tumors
colorectal_adenocarcinoma	colorectal adenocarcinoma
mature_cystic_teratoma	mature cystic teratoma
idiopathic_or_surgical_hypoparathyroidism	idiopathic or surgical hypoparathyroidism
go	go
arterial_thrombosis	arterial thrombosis
3-oxauracil	3-oxauracil
myocardial_interstitial_fibrosis	myocardial interstitial fibrosis
als	als
1-methoxypropanol-2	1-methoxypropanol-2
lambert-eaton_myasthenic_syndrome	lambert-eaton myasthenic syndrome
17hpc	17hpc
major_depression	major depression
esophageal_tumors	esophageal tumors
2-pentene_1-4-olide	2-pentene 1-4-olide
astrocytoma	astrocytoma
pre-cancers	pre-cancers
aud	aud
4-methyl_pyrazole	4-methyl pyrazole
2,3-butanedione_2-monoxime	2,3-butanedione 2-monoxime
1-o-octadecyl-2-o-methylglycero-3-phosphocholine	1-o-octadecyl-2-o-methylglycero-3-phosphocholine
ald	ald
5-aris	5-aris
3-nitro-tyrosine	3-nitro-tyrosine
uvb-induced_cell_damage_in_rabbit_cornea	uvb-induced cell damage in rabbit cornea
ascariasis	ascariasis
convulsions	convulsions
glioblastoma	glioblastoma
2-dg	2-dg
encephalomyelitis	encephalomyelitis
1-methylsilacyclobutane	1-methylsilacyclobutane
colony-forming_cells	colony-forming cells
4-oh-tamoxifen	4-oh-tamoxifen
lpk	lpk
neurochemical_and_functional_deficits	neurochemical and functional deficits
skin_carcinogenesis	skin carcinogenesis
adrenocortical_carcinoma	adrenocortical carcinoma
hepatoma	hepatoma
distal_colitis	distal colitis
proton_leak	proton leak
1-0-alkyl-2-acetyl-sn-glycero-3-phosphorylcholine	1-0-alkyl-2-acetyl-sn-glycero-3-phosphorylcholine
12-o-tetra-decanoylphorbol-13-acetate	12-o-tetra-decanoylphorbol-13-acetate
glioblastomas	glioblastomas
2,4,5-tmc	2,4,5-tmc
17-dimethylaminoethylamino-17-demethoxy-geldanamycin	17-dimethylaminoethylamino-17-demethoxy-geldanamycin
nephropathy	nephropathy
inflammatory_bowel_diseases	inflammatory bowel diseases
metabolic_diseases	metabolic diseases
rous_sarcoma	rous sarcoma
1,5-anhydroglucitol	1,5-anhydroglucitol
occupational_hand_dermatitis	occupational hand dermatitis
2-o-methylantimycin	2-o-methylantimycin
4-hydroxyaminoquinoline_1-oxide_hydrochloride	4-hydroxyaminoquinoline 1-oxide hydrochloride
5-aminoimidazole-4-carboxamide-1-riboside	5-aminoimidazole-4-carboxamide-1-riboside
111indium-dtpa	111indium-dtpa
bronchial_carcinoma	bronchial carcinoma
biliary_duct_necrosis	biliary duct necrosis
4nqo	4nqo
intracranial_tumors	intracranial tumors
cardiovascular_risk	cardiovascular risk
paraplegia	paraplegia
25-amino_acid	25-amino acid
intestinal_carcinoma	intestinal carcinoma
12-hydroxyheptadecadienoic	12-hydroxyheptadecadienoic
rnos	rnos
2,4:3,5-dibenzylidene-d-xylose-diethyl_dithioacetal	2,4:3,5-dibenzylidene-d-xylose-diethyl dithioacetal
1-benzyloxy-methyl-5-ethyl-6-phenylthiouracil	1-benzyloxy-methyl-5-ethyl-6-phenylthiouracil
zd	zd
3-hydroxyterphenyllin	3-hydroxyterphenyllin
5,6-benzo-alpha-pyrone	5,6-benzo-alpha-pyrone
hcl-v	hcl-v
3,5,3-triiodo-l-thyronine	3,5,3-triiodo-l-thyronine
allergic_airway_inflammation	allergic airway inflammation
2-bfi	2-bfi
papillomas	papillomas
2,4,6-trinitrobenzene_sulphonic_acid	2,4,6-trinitrobenzene sulphonic acid
177lu-octreotate	177lu-octreotate
4-nitrobenzonitrile	4-nitrobenzonitrile
lymphocytic_lymphomas	lymphocytic lymphomas
2-n-fluorenylacetamide	2-n-fluorenylacetamide
polyneuropathy	polyneuropathy
2,3-dimercaptosuccinic_acids	2,3-dimercaptosuccinic acids
thymoma_tumour	thymoma tumour
cerebrovascular_abnormalities	cerebrovascular abnormalities
mp	mp
1-phenyl-2-1-phenylpropyl-3-amino_proprane_hydrochloride	1-phenyl-2-1-phenylpropyl-3-amino proprane hydrochloride
18f-dopa_pet	18f-dopa pet
3-morpholinosyndnonimine	3-morpholinosyndnonimine
vesicular_stomatitis	vesicular stomatitis
neuroendocrine_tumour	neuroendocrine tumour
18-hydroxy-deoxycorticosterone	18-hydroxy-deoxycorticosterone
1,4,5-trialkyl-2-thioimidazole	1,4,5-trialkyl-2-thioimidazole
19-norandrosterone	19-norandrosterone
polyuria	polyuria
gland_soft_tissue_lesion	gland soft tissue lesion
3-methyl-5-phenylpentanol	3-methyl-5-phenylpentanol
1,4-dithiane	1,4-dithiane
4-vo/ica	4-vo/ica
hypovitaminosis_d	hypovitaminosis d
crs	crs
carcinogenesis	carcinogenesis
diabetic_nephropathy	diabetic nephropathy
fever	fever
111in-dtpa-peptide-biotin	111in-dtpa-peptide-biotin
2-hydroxycinnamaldehyde	2-hydroxycinnamaldehyde
4-hydroxy-3_methoxy_mandelic_acid	4-hydroxy-3 methoxy mandelic acid
diabetic_glomerulosclerosis	diabetic glomerulosclerosis
2-biphenylamine_hydrochloride	2-biphenylamine hydrochloride
osteomalacia	osteomalacia
non-small_cell_lung_cancer	non-small cell lung cancer
nigrostriatal_injury	nigrostriatal injury
17beta-estradiol	17beta-estradiol
tnbs_colitis	tnbs colitis
4-oxo-isotretinoin	4-oxo-isotretinoin
idc	idc
18alpha-glycyrrhizin	18alpha-glycyrrhizin
1,25_dihydroxy_vitamin_d3	1,25 dihydroxy vitamin d3
gastrointestinal_tumors	gastrointestinal tumors
hc	hc
rcts	rcts
5alpha-dht	5alpha-dht
25hc	25hc
4-aminophenyl-b-d-galactopyranoside	4-aminophenyl-b-d-galactopyranoside
ocular_inflammation	ocular inflammation
mca_occlusion	mca occlusion
2-o-phosphorylated_ascorbate-6-o-palmitylester	2-o-phosphorylated ascorbate-6-o-palmitylester
non-fatal_intoxication	non-fatal intoxication
attenuated_deficiency	attenuated deficiency
hyalinization	hyalinization
1,5-diarylpyrazoles	1,5-diarylpyrazoles
1:4-saccharolactone	1:4-saccharolactone
2,4,6-trihydroxyphenethylamine	2,4,6-trihydroxyphenethylamine
1,4-hydrazone	1,4-hydrazone
25-oh-vitamin_d	25-oh-vitamin d
131i-iodine	131i-iodine
2-mercaptoethanol_sodium_sulfonate	2-mercaptoethanol sodium sulfonate
3-aminothymidine	3-aminothymidine
carcinoma_of_the_prostate	carcinoma of the prostate
11c-ac	11c-ac
secondary_hyperparathyroidism	secondary hyperparathyroidism
5,6_mexaa	5,6 mexaa
fragmentation	fragmentation
prolactinomas	prolactinomas
hcv_infection	hcv infection
2-mercaptoethanesulfonate	2-mercaptoethanesulfonate
ceroid-lipofuscinosis	ceroid-lipofuscinosis
circulatory_failure_and_attenuates_the_dysfunction_of_liver	circulatory failure and attenuates the dysfunction of liver
24,25-dioh-d3	24,25-dioh-d3
3-hydroxyflavone	3-hydroxyflavone
influenza_c_virus	influenza c virus
hypertension	hypertension
t2dm	t2dm
5-aminovaleric_acid	5-aminovaleric acid
hypertensives	hypertensives
ketosis	ketosis
27hc	27hc
1-monolinolein	1-monolinolein
11-hydroxycorticosteroids	11-hydroxycorticosteroids
11c-l-methionine	11c-l-methionine
galactorrhea	galactorrhea
13l	13l
4bhwe	4bhwe
3-hydroxy-3-methylglutaryl	3-hydroxy-3-methylglutaryl
2-vo	2-vo
cerebral_vasospasm	cerebral vasospasm
1,5-isoquinelinediol	1,5-isoquinelinediol
heart_diseases	heart diseases
parkinson_disease	parkinson disease
hu	hu
myocardial_necrosis	myocardial necrosis
sila	sila
3-hydroxy-3-methylglutaryl-coa	3-hydroxy-3-methylglutaryl-coa
bladder_obstruction	bladder obstruction
3h-nicotine	3h-nicotine
localized_prostate_cancer	localized prostate cancer
1,4-diethynylbenzene	1,4-diethynylbenzene
cognitive_impairment	cognitive impairment
pdb	pdb
3_beta-hydroxy-delta_5-c27-steroid	3 beta-hydroxy-delta 5-c27-steroid
14c-d-xylose	14c-d-xylose
cd	cd
14-amino-acid	14-amino-acid
lung_injury	lung injury
ovarian_carcinoma	ovarian carcinoma
ltbi	ltbi
1-naphthyl_chlorocarbonate	1-naphthyl chlorocarbonate
adenoid_cystic_carcinoma	adenoid cystic carcinoma
atherosclerotic	atherosclerotic
3,5-me2-napqi	3,5-me2-napqi
somatostatin-receptor-positive_cancers	somatostatin-receptor-positive cancers
deficits_in_working_memory	deficits in working memory
burn_injury	burn injury
25-hydroxyvd-25ohd	25-hydroxyvd-25ohd
increased_alkaline_fragility	increased alkaline fragility
invasiveness_of_salmonella	invasiveness of salmonella
increases_life_span_of_leukemia	increases life span of leukemia
medullary_carcinoma	medullary carcinoma
2n	2n
cognitive_decline	cognitive decline
bruxism	bruxism
hl-60_myeloid_leukemic	hl-60 myeloid leukemic
gastric_emptying	gastric emptying
impaired_motor_coordination	impaired motor coordination
4-diamino-diphenylsulfone	4-diamino-diphenylsulfone
primary_aldosteronism	primary aldosteronism
3g4	3g4
4-oht_gel	4-oht gel
ptsd	ptsd
papillary_meningioma	papillary meningioma
wnv_infection	wnv infection
3-methylfentanyl	3-methylfentanyl
neuronal_dysfunction	neuronal dysfunction
hd	hd
pdac	pdac
anabolic_steroid	anabolic steroid
3h-1,2-dithiole-3-thione	3h-1,2-dithiole-3-thione
tbi	tbi
5/9	5/9
vasomotor_symptoms	vasomotor symptoms
urothelial_toxicity	urothelial toxicity
polycystic_ovary_syndrome	polycystic ovary syndrome
eaton-lambert_syndrome	eaton-lambert syndrome
2,4,6-triaminopyrimidine	2,4,6-triaminopyrimidine
hyperparathyroidism	hyperparathyroidism
melanoma	melanoma
2-oxa-3-oxocastanospermine	2-oxa-3-oxocastanospermine
2h	2h
gvh	gvh
1-o-acyl	1-o-acyl
hypercalciuria	hypercalciuria
allergic_contact_dermatitis	allergic contact dermatitis
ts	ts
2-hydroxy-4-trifluorometylbenzoic_acid	2-hydroxy-4-trifluorometylbenzoic acid
2,3-dideoxycytidine	2,3-dideoxycytidine
1-deoxymannojirimycin	1-deoxymannojirimycin
cognitive_symptoms	cognitive symptoms
parkinsonian_neurotoxins	parkinsonian neurotoxins
2,4-dinitrophenol	2,4-dinitrophenol
lumbar_lordosis	lumbar lordosis
aggressive_lymphoma	aggressive lymphoma
platelet_adhesion	platelet adhesion
3-hydroxyisobutyric_aciduria	3-hydroxyisobutyric aciduria
axonal_degeneration	axonal degeneration
tlr9-d	tlr9-d
3,4-pyruvylated_galactose	3,4-pyruvylated galactose
1,5-anhydro-d-fructose	1,5-anhydro-d-fructose
sarcopenia	sarcopenia
psc	psc
2-brhda	2-brhda
sbcadd	sbcadd
granuloma	granuloma
allergic_disease	allergic disease
epileptiform_activity	epileptiform activity
3-benzylsydnone-4-acetamide	3-benzylsydnone-4-acetamide
breast_carcinomas	breast carcinomas
4-isopropyl-dibenzoylmethane	4-isopropyl-dibenzoylmethane
2-hydrazinopyrimidine	2-hydrazinopyrimidine
2-methoxy-antimycin_a	2-methoxy-antimycin a
5,6_beta-epoxy-5_alpha-cholestan-3_beta-ol	5,6 beta-epoxy-5 alpha-cholestan-3 beta-ol
pel	pel
primary_lesion	primary lesion
ic	ic
2,4,6-trinitrobenzene_sulfonic_acid	2,4,6-trinitrobenzene sulfonic acid
5,6-epoxyeicosatrienoic_acid	5,6-epoxyeicosatrienoic acid
reye_syndrome-like_illness	reye syndrome-like illness
malignant_tumor	malignant tumor
2,4-dinitroimidazole-1-ethanol	2,4-dinitroimidazole-1-ethanol
131-i-bromsulphalein	131-i-bromsulphalein
4-methylcoumarin	4-methylcoumarin
sah	sah
hh	hh
19-nor-deoxycorticosterone	19-nor-deoxycorticosterone
2,4-dichlorophenol	2,4-dichlorophenol
deficiency_in_isovaleryl-coa_dehydrogenase	deficiency in isovaleryl-coa dehydrogenase
aas	aas
genetic_algorithm	genetic algorithm
dehydrogenase_deficiency	dehydrogenase deficiency
various_disease	various disease
constriction	constriction
22-oxa-1,25-dihydroxyvitamin_d3	22-oxa-1,25-dihydroxyvitamin d3
1-aminocyclopentanecarboxylic_acid	1-aminocyclopentanecarboxylic acid
protein-energy_malnutrition	protein-energy malnutrition
motor_deficits	motor deficits
refractory_distal_ulcerative_colitis	refractory distal ulcerative colitis
bacterial_overgrowth	bacterial overgrowth
5,6-dht	5,6-dht
adrenocortical_adenomas	adrenocortical adenomas
3-bromo-1-hydroxy-9,10-anthraquinone	3-bromo-1-hydroxy-9,10-anthraquinone
stomach_cancer	stomach cancer
2,3-benzo-1,4-dimethyl-alpha-iso-carboline	2,3-benzo-1,4-dimethyl-alpha-iso-carboline
diabetic_renal_disease	diabetic renal disease
3-epica	3-epica
4-oh-cb-107	4-oh-cb-107
neurotoxic	neurotoxic
epidermal_hyperplasia	epidermal hyperplasia
hepatic_malt	hepatic malt
1-octadecyl-2-methyl-rac-glycero-3-phosphocholine	1-octadecyl-2-methyl-rac-glycero-3-phosphocholine
prostatic_hypertrophy	prostatic hypertrophy
10-edam	10-edam
artery_occlusion_shock	artery occlusion shock
nb	nb
crc	crc
nephrotoxicity	nephrotoxicity
low-valent_nb	low-valent nb
peripheral_neuropathies	peripheral neuropathies
3-deoxyoctitols	3-deoxyoctitols
carbon-centred_and_hydroxyl_radicals	carbon-centred and hydroxyl radicals
2-methyl-3-hydroxy-5_keto_esters	2-methyl-3-hydroxy-5 keto esters
postmenopausal_atrophic_vaginitis	postmenopausal atrophic vaginitis
depressions	depressions
neurological_sequelae	neurological sequelae
12-o-tetradecanoyl-phorbol-13_acetate	12-o-tetradecanoyl-phorbol-13 acetate
5,6-trans-25-hydroxycholecalciferol	5,6-trans-25-hydroxycholecalciferol
mitochondrial_damage	mitochondrial damage
deficit_hyperactivity_disorder	deficit hyperactivity disorder
diversion_colitis	diversion colitis
gametopathies_and_fetal_death	gametopathies and fetal death
vesicle_aggregation	vesicle aggregation
2,2,5-trimethyl-5-pentylcyclopentanone	2,2,5-trimethyl-5-pentylcyclopentanone
bleeding	bleeding
3-dimethylaminopropylamine	3-dimethylaminopropylamine
5,7-dimethoxyflavone	5,7-dimethoxyflavone
4-methylimidazole	4-methylimidazole
hepatic_damage	hepatic damage
1-palmitoyl-2-arachidonoyl-sn-glycerol-3-phosphatidylcholine	1-palmitoyl-2-arachidonoyl-sn-glycerol-3-phosphatidylcholine
14c-tu	14c-tu
fle	fle
neonatal_adrenoleukodystrophy	neonatal adrenoleukodystrophy
damage_in_the_nigrostriatal_system	damage in the nigrostriatal system
2-beta-d-ribofuranosylthiazole-4-carboxamide	2-beta-d-ribofuranosylthiazole-4-carboxamide
1-napththylisothiocyanate	1-napththylisothiocyanate
4-aepb	4-aepb
ventricular_myocardium	ventricular myocardium
4-14c-t	4-14c-t
enlargement_of_the_adrenal_medulla	enlargement of the adrenal medulla
4-hydroxy_clo	4-hydroxy clo
mds	mds
3-hydroxylacyl-coa	3-hydroxylacyl-coa
transitional_cell_carcinoma	transitional cell carcinoma
2-ethoxyethanol_acetate	2-ethoxyethanol acetate
1.4-dihydroxy-2-naphthoic_acid	1.4-dihydroxy-2-naphthoic acid
2-aadt	2-aadt
unipolar_depressed	unipolar depressed
choke_ii	choke ii
b_cell_leukemia	b cell leukemia
1-mcp	1-mcp
pancreatic_ductal_adenocarcinoma	pancreatic ductal adenocarcinoma
as	as
17-alpha-hydroxyprogesterone	17-alpha-hydroxyprogesterone
td	td
filarial_lymphoedema	filarial lymphoedema
4-bromophenol	4-bromophenol
25_hydroxyvitamin_d	25 hydroxyvitamin d
4aaqb	4aaqb
123i-ioflupane	123i-ioflupane
brain_ischemia	brain ischemia
186re-sulfide	186re-sulfide
splenomegaly	splenomegaly
3-phenylactetylamino-2,6-piperidinedione	3-phenylactetylamino-2,6-piperidinedione
4-abp	4-abp
1-benzyl-1,2,3,4-tetrahydroisoquinoline	1-benzyl-1,2,3,4-tetrahydroisoquinoline
aciduria	aciduria
4-amino-2-trifluoromethyl-phenyl_retinate	4-amino-2-trifluoromethyl-phenyl retinate
15-m-pge1	15-m-pge1
3-methylcholanthrene	3-methylcholanthrene
colonic_inflammation	colonic inflammation
2-apc	2-apc
3b-hsd_deficiency	3b-hsd deficiency
intramolecular_charge_transfer	intramolecular charge transfer
toxic_dermatitis	toxic dermatitis
3-vinylazetidin-2-ones	3-vinylazetidin-2-ones
1,3-dicyclohexylurea	1,3-dicyclohexylurea
respiratory_and_bile_duct_tumors	respiratory and bile duct tumors
5,8,11,14-eicosatetraynoic_acid	5,8,11,14-eicosatetraynoic acid
interstitial_nephritis	interstitial nephritis
14c-thymidine	14c-thymidine
allosteric_enhancers	allosteric enhancers
108/124	108/124
falciparum	falciparum
12-0-tetradecanoyl_phorbol-13-acetate	12-0-tetradecanoyl phorbol-13-acetate
papillary_necrosis	papillary necrosis
neurological_disorders	neurological disorders
neurotoxic_conditions	neurotoxic conditions
hematopoietic	hematopoietic
bone_disease	bone disease
status_epilepticus	status epilepticus
breast	breast
2-hydroxy_fatty_acids	2-hydroxy fatty acids
2-apb	2-apb
vascular_permeability	vascular permeability
1-dnj	1-dnj
12-mta	12-mta
18f-dvip	18f-dvip
20-hydroxynortriptyline	20-hydroxynortriptyline
223ra	223ra
12-o-tetradecanolylphorbol-13-acetate	12-o-tetradecanolylphorbol-13-acetate
131-iodine	131-iodine
4-f-glcnac	4-f-glcnac
n-linked_glycosylation	n-linked glycosylation
gingival_overgrowth	gingival overgrowth
fhpt	fhpt
hyaluronic_acid	hyaluronic acid
3,4-dihydroxy-l-phenylalanine	3,4-dihydroxy-l-phenylalanine
trachea	trachea
malignant_cerebral_glioma	malignant cerebral glioma
2-hydroxyestradiol	2-hydroxyestradiol
51chromium	51chromium
17ss-estradiol	17ss-estradiol
cervix_carcinoma	cervix carcinoma
acute_damage	acute damage
pneumonitis	pneumonitis
deaths	deaths
2,3-dhba	2,3-dhba
gastric_mucosa_damage	gastric mucosa damage
cannabis	cannabis
2q33-q34	2q33-q34
myeloid_leukemia	myeloid leukemia
multiple_tumor	multiple tumor
4-desmethyl-10,11-didehydroepothilone_d	4-desmethyl-10,11-didehydroepothilone d
bv	bv
153sm_edtmp	153sm edtmp
2-thiouracil	2-thiouracil
lymph_node_tuberculosis	lymph node tuberculosis
sympathomimetic_toxicity	sympathomimetic toxicity
2-benzylidene-2,3-dihydro-1h-inden-1-one	2-benzylidene-2,3-dihydro-1h-inden-1-one
sepsis	sepsis
inflammation	inflammation
4-hydroxyestrogen	4-hydroxyestrogen
4-oht	4-oht
estrogen_receptor_positive_breast_cancer	estrogen receptor positive breast cancer
2-dogta	2-dogta
hyperglycemic	hyperglycemic
proctitis	proctitis
post-partum_thyroiditis	post-partum thyroiditis
astrocytomas	astrocytomas
1,5-pentanediol	1,5-pentanediol
4-o-demethyl-11-deoxydoxorubicin	4-o-demethyl-11-deoxydoxorubicin
5,6-mexaa	5,6-mexaa
dfna	dfna
5,7-dimethoxy-2-phenyl-n-propylquinolin-4-amine	5,7-dimethoxy-2-phenyl-n-propylquinolin-4-amine
4-hpr	4-hpr
177lu-labeled_cyclic_polyaminophosphonates	177lu-labeled cyclic polyaminophosphonates
spasm	spasm
ah	ah
mitochondrial_impairment	mitochondrial impairment
2-bromopalmitoyl-coa	2-bromopalmitoyl-coa
hyperthermia	hyperthermia
hormone_refractory_prostate_cancer	hormone refractory prostate cancer
ang	ang
11c-choline_pet	11c-choline pet
4-hydroxy-2-oxoglutarate	4-hydroxy-2-oxoglutarate
la	la
2-aminoethanesulphonic_acid	2-aminoethanesulphonic acid
4-meoen	4-meoen
5-adenosylhomocysteine	5-adenosylhomocysteine
asthmatic	asthmatic
2-0-tetradecanoyl-phorbol-13-acetate	2-0-tetradecanoyl-phorbol-13-acetate
brain_hypoperfusion	brain hypoperfusion
2-oxo-oximes	2-oxo-oximes
2-mesadp	2-mesadp
4-hydroxyderricin	4-hydroxyderricin
zona_glomerulosa	zona glomerulosa
salivary_gland_carcinomas	salivary gland carcinomas
10b1-paraboronophenylalanine-hcl	10b1-paraboronophenylalanine-hcl
sams	sams
2-anthramine	2-anthramine
dss	dss
2,6-dichlorodiphenylamine	2,6-dichlorodiphenylamine
trauma	trauma
arthritic_joints	arthritic joints
non-vdd	non-vdd
13c-hiolein	13c-hiolein
acne	acne
parsonage-turner_syndrome	parsonage-turner syndrome
4-hydroxypanduratin_a	4-hydroxypanduratin a
3-amino-5-mercapto-1,2,4-triazole	3-amino-5-mercapto-1,2,4-triazole
visceral_pain	visceral pain
5,7-dihydroxytryptamine	5,7-dihydroxytryptamine
low-grade_lymphomas	low-grade lymphomas
3,4-methylenedioxymethylamphetamine	3,4-methylenedioxymethylamphetamine
111in-octreotide	111in-octreotide
hepatitis_b	hepatitis b
3c-pitc	3c-pitc
11-hydroxycorticosteroid	11-hydroxycorticosteroid
1-beta-d-arabinofuranosylcytosine	1-beta-d-arabinofuranosylcytosine
eruption	eruption
hl-rt	hl-rt
head_and_neck_cancer	head and neck cancer
cerebral_glioma	cerebral glioma
3-deazauridine	3-deazauridine
2,3-dcpe	2,3-dcpe
pah	pah
13,14-dihydro-15-keto-pge2	13,14-dihydro-15-keto-pge2
3-hk	3-hk
androgen-responsive_tumors	androgen-responsive tumors
nsclc	nsclc
1-hexadecyl-3-methylimidazolium_chloride	1-hexadecyl-3-methylimidazolium chloride
brain_edema	brain edema
vd	vd
17-methoxyl-7-hydroxy-benzene-furanchalcone	17-methoxyl-7-hydroxy-benzene-furanchalcone
experimental_leukemias	experimental leukemias
4,6-benzylidene-d1-d-glucose	4,6-benzylidene-d1-d-glucose
4-phenoxyquinoline	4-phenoxyquinoline
24,25-dihydroxycholecalciferol	24,25-dihydroxycholecalciferol
129cs	129cs
depressed_spontaneous_locomotor_activity	depressed spontaneous locomotor activity
glioma	glioma
erythrocyte_glucose_consumption	erythrocyte glucose consumption
conformational_change_of_rubella_virus_spike_proteins	conformational change of rubella virus spike proteins
malignancy_of_cancer	malignancy of cancer
18-fdg	18-fdg
intestinal_lesions	intestinal lesions
cholestatic_liver_failure	cholestatic liver failure
retinoic_acid	retinoic acid
gastric_lesions	gastric lesions
4-hydroxyaminoquinoline_1-oxide	4-hydroxyaminoquinoline 1-oxide
short_stature	short stature
23,24-dihydrocucurbitacin_b	23,24-dihydrocucurbitacin b
decalepis_hamiltonii_roots	decalepis hamiltonii roots
autoimmune_thyroiditis	autoimmune thyroiditis
111indium_pentetreotide	111indium pentetreotide
1-propyl-1-nitrosourea	1-propyl-1-nitrosourea
hpa_axis	hpa axis
rop	rop
3d-ctc	3d-ctc
2-deoxy_glucose	2-deoxy glucose
4sc-201	4sc-201
ui	ui
colonic_injury	colonic injury
ovarian_hyperandrogenism	ovarian hyperandrogenism
mitochondrial_dysfunction	mitochondrial dysfunction
3-oxypyridine	3-oxypyridine
4-nitroaniline	4-nitroaniline
2-methoxy_antimycin_a3	2-methoxy antimycin a3
cardiovascular_symptoms	cardiovascular symptoms
4-aminophenylmercuric_acetate	4-aminophenylmercuric acetate
ckd	ckd
muscle_proteolysis	muscle proteolysis
mouse_leukemia	mouse leukemia
radiation_injury	radiation injury
gastric_lymphoma	gastric lymphoma
244cmo2	244cmo2
hypopharynx_cancer	hypopharynx cancer
breast_tumors	breast tumors
allergic_rhinitis	allergic rhinitis
14c-pmm	14c-pmm
isovaleric_acidemia	isovaleric acidemia
3-aminobenzamide	3-aminobenzamide
3hia-carnitine	3hia-carnitine
14c-radiolabelled_elliptinium_acetate	14c-radiolabelled elliptinium acetate
malt_lymphoma	malt lymphoma
haloarchaeal_strain	haloarchaeal strain
gm2-gangliosidosis	gm2-gangliosidosis
3-methoxydocosanoic_and_3-methoxytetracosanoic_acids	3-methoxydocosanoic and 3-methoxytetracosanoic acids
endophytic_squamous_cell_carcinomas	endophytic squamous cell carcinomas
vte	vte
pulmonary_tumors	pulmonary tumors
177lu-labeled_octreotate	177lu-labeled octreotate
5-amino_salicylic_acid	5-amino salicylic acid
15-hetre-dag	15-hetre-dag
1-amino-3-hydroxy-5-methyl-4-isoxazolepropionate	1-amino-3-hydroxy-5-methyl-4-isoxazolepropionate
acne_vulgaris	acne vulgaris
head_louse_infestation	head louse infestation
1,3,4-thiadiazines	1,3,4-thiadiazines
switchable_polarity_solvents	switchable polarity solvents
respiratory_diseases	respiratory diseases
ebv	ebv
17a-ethinylestradiol	17a-ethinylestradiol
4-riba	4-riba
thrombocytopenia	thrombocytopenia
pancreatitis	pancreatitis
ac	ac
1-oh_midazolam_glucuronide	1-oh midazolam glucuronide
liver_cancer	liver cancer
eat	eat
alloxan_diabetes	alloxan diabetes
vascular_dysfunction	vascular dysfunction
familial_amyloid_polyneuropathy_type_i	familial amyloid polyneuropathy type i
sensorineural_hearing_loss	sensorineural hearing loss
3h-e2	3h-e2
mcl	mcl
hypotonia	hypotonia
2,4-dien-vpa	2,4-dien-vpa
51cr-beta-glycerophosphate	51cr-beta-glycerophosphate
calcium_deficiency	calcium deficiency
3h-tyrosine	3h-tyrosine
folate_deficiency	folate deficiency
cerebral_injury	cerebral injury
18f_fluorodeoxyglucose	18f fluorodeoxyglucose
self-assembled_monolayers	self-assembled monolayers
1,2-dimethylthdrazine	1,2-dimethylthdrazine
decreased_hyperplasia	decreased hyperplasia
2,4-dinitrochlorobenzene	2,4-dinitrochlorobenzene
demyelinated_rat_sciatic_nerve	demyelinated rat sciatic nerve
carcinoma_in_situ	carcinoma in situ
1,4-naphthoquinones	1,4-naphthoquinones
4tcna	4tcna
gestational_diabetes_mellitus	gestational diabetes mellitus
3-chlorotyrosine	3-chlorotyrosine
catabolic_block	catabolic block
2,4-dinitrobenzene_sulfonic_acid	2,4-dinitrobenzene sulfonic acid
17pc	17pc
11beta-ohd	11beta-ohd
myelodysplastic_syndromes	myelodysplastic syndromes
intrauterine_growth_retardation	intrauterine growth retardation
musculoskeletal_pain	musculoskeletal pain
unruptured_cerebral_aneurysm	unruptured cerebral aneurysm
1,4-cyclohexadiene	1,4-cyclohexadiene
35s-sulfate	35s-sulfate
1,3-dinitrobenzene	1,3-dinitrobenzene
57co-bleomycin	57co-bleomycin
17oh_progesterone	17oh progesterone
fhl	fhl
deterioration_of_vascular_complications	deterioration of vascular complications
177lu-dota-eb-tate	177lu-dota-eb-tate
4-coumaric_acid	4-coumaric acid
2-amino-7-phosphono_heptanoate	2-amino-7-phosphono heptanoate
brain_injury	brain injury
4-toluenesulfonate	4-toluenesulfonate
1-palmitoyl-2-linoleoyl-3-acetylglycerol	1-palmitoyl-2-linoleoyl-3-acetylglycerol
ulcers	ulcers
chronic_renal_insufficiency	chronic renal insufficiency
2-hydroxy-4-methoxy_benzoic_acid	2-hydroxy-4-methoxy benzoic acid
sm	sm
hcc	hcc
anoxia	anoxia
3,4,5-trihydroxybenzoic_acid	3,4,5-trihydroxybenzoic acid
cystic_fibrosis	cystic fibrosis
1,25_dihydroxy-vitamin_d3	1,25 dihydroxy-vitamin d3
immunodeficiency	immunodeficiency
lymphomas_or_leukemias	lymphomas or leukemias
induction_period	induction period
5123tc	5123tc
adipose_dysfunction	adipose dysfunction
subchronic_toxicity	subchronic toxicity
aortic_aneurysm	aortic aneurysm
17-b-estrodiol	17-b-estrodiol
agranulocytosis	agranulocytosis
1-o-alkyl_lysophospholipid	1-o-alkyl lysophospholipid
-3_pufa	-3 pufa
mts	mts
ovarian_cancer	ovarian cancer
4beta-phorbol_12,13-dibutyrate	4beta-phorbol 12,13-dibutyrate
4-ohb	4-ohb
2-me	2-me
111in-psma-617	111in-psma-617
3-br-7ni	3-br-7ni
squamous_cell_carcinomas	squamous cell carcinomas
2-bromo-alpha-ergocryptine	2-bromo-alpha-ergocryptine
rhinovirus_infection	rhinovirus infection
influenza	influenza
11-oxygenated-c19_androgens	11-oxygenated-c19 androgens
poag	poag
neuronal_injury	neuronal injury
reductase_deficiency	reductase deficiency
leucopenia	leucopenia
13-trans_retinoic_acid	13-trans retinoic acid
critical_cardiac_output	critical cardiac output
quantum_dots	quantum dots
hplc_separation	hplc separation
3,4-dihydroxyphenylacetic_and_homovanillic_acids	3,4-dihydroxyphenylacetic and homovanillic acids
1-hydroxymethylene-1,1-bisphosphonic_acids	1-hydroxymethylene-1,1-bisphosphonic acids
high-turnover_osteopenia	high-turnover osteopenia
non-diabeteic_seniors	non-diabeteic seniors
ischemic_injury	ischemic injury
1-methyl-1,2,3,4-tetrahydro-beta-carboline-3-carboxylic_acid	1-methyl-1,2,3,4-tetrahydro-beta-carboline-3-carboxylic acid
cervical_intraepithelial_neoplasia	cervical intraepithelial neoplasia
4-asa	4-asa
13-methoxy-15-oxozoapatlin	13-methoxy-15-oxozoapatlin
pws	pws
166ho-dotmp	166ho-dotmp
yoshida_tumors	yoshida tumors
lca	lca
tnt	tnt
3-aminoindazole	3-aminoindazole
fa	fa
autoimmune_hemolytic_anemia	autoimmune hemolytic anemia
3a,5a-thp	3a,5a-thp
breast_adenocarcinoma	breast adenocarcinoma
19-oh-a	19-oh-a
1,4-dioxane	1,4-dioxane
neurological_syndrome	neurological syndrome
cms	cms
cold_ischemia	cold ischemia
testis_injury	testis injury
subscleral_hygroma	subscleral hygroma
17-amino_acid_peptide	17-amino acid peptide
17-ee	17-ee
initial_pancytopenia	initial pancytopenia
pericarditis	pericarditis
1-b-d-arabinofuranosyl_cytosine	1-b-d-arabinofuranosyl cytosine
17-ohd	17-ohd
2,2-dimethyl-3-phenylpropanol	2,2-dimethyl-3-phenylpropanol
aplastic_anemia	aplastic anemia
1-amino-4-phenyl-1,2,3,6-tetrahydropyridine	1-amino-4-phenyl-1,2,3,6-tetrahydropyridine
3-keto_oleane_triterpenes	3-keto oleane triterpenes
methemoglobinemia	methemoglobinemia
4-hydroxy-2,2,6,6-tetramethylpiperidine-n-oxyl	4-hydroxy-2,2,6,6-tetramethylpiperidine-n-oxyl
precancerous	precancerous
2,3,7,8_tetrachloro_dibenzo-p-dioxin	2,3,7,8 tetrachloro dibenzo-p-dioxin
temporal_lobe_epilepsy	temporal lobe epilepsy
24_l-phenylalanine	24 l-phenylalanine
2-aaf	2-aaf
cardiac_muscle_preparations	cardiac muscle preparations
125i-iododeoxyuridine	125i-iododeoxyuridine
2,3,7,8_tetrachlorodibenzo-p-dioxin	2,3,7,8 tetrachlorodibenzo-p-dioxin
2e	2e
3alpha-epithio-5alpha-androstand-17beta-yl_1-methoxy-cyclopentyl_ether	3alpha-epithio-5alpha-androstand-17beta-yl 1-methoxy-cyclopentyl ether
kidney_stones	kidney stones
heart_and_the_liver	heart and the liver
muscle_weakness	muscle weakness
papillary_thyroid_carcinoma	papillary thyroid carcinoma
muscle_wasting	muscle wasting
2-octynoic_acid	2-octynoic acid
myelodysplastic_syndrome	myelodysplastic syndrome
pd	pd
2,3-butanedione_monoxime	2,3-butanedione monoxime
cerebral_oedema	cerebral oedema
multiple_sclerosis	multiple sclerosis
ipsiversive_rotation	ipsiversive rotation
vasomotor_rhinitis	vasomotor rhinitis
12-o-tetradecanoylphobol_13-acetate	12-o-tetradecanoylphobol 13-acetate
premature_labor	premature labor
gestational_diabetes	gestational diabetes
25_hydroxy_vitamin_d	25 hydroxy vitamin d
mhd	mhd
5,7-dichloro-8-hydroxyquinaldine	5,7-dichloro-8-hydroxyquinaldine
1-palmitoyl-2-arachidonoyl-sn-glycero-3-phosphorylcholine	1-palmitoyl-2-arachidonoyl-sn-glycero-3-phosphorylcholine
uremia	uremia
dimeric_to_hexameric_composition	dimeric to hexameric composition
18f-naf	18f-naf
platelet_aggregation	platelet aggregation
2-nitroimidazoles	2-nitroimidazoles
1-thc	1-thc
42-amino-acid	42-amino-acid
2hg	2hg
ruptured_aneurysm	ruptured aneurysm
weibel-palade_body_mobilization	weibel-palade body mobilization
benign_prostatic_hyperplasia	benign prostatic hyperplasia
3-aminopropanal	3-aminopropanal
degeneration_of_the_nigrostriatal_bundles	degeneration of the nigrostriatal bundles
2-phenyl-3-methyl-tetrahydro-1_,4-oxazine	2-phenyl-3-methyl-tetrahydro-1 ,4-oxazine
ptb	ptb
epilepsy	epilepsy
decrease_in_locomotor_activity	decrease in locomotor activity
3m-052	3m-052
4-ha	4-ha
2-nitroimidazole-1-acetohydroxamate	2-nitroimidazole-1-acetohydroxamate
1-sulpiride	1-sulpiride
13od	13od
3,4-dhap	3,4-dhap
4-vinyl_cyclohexene_diepoxide	4-vinyl cyclohexene diepoxide
local_inflammation	local inflammation
epithelial_injury	epithelial injury
hpa	hpa
2-arachidonoylglycerol	2-arachidonoylglycerol
22-oxacalcitriol	22-oxacalcitriol
1,3,5-trinitrobenzene	1,3,5-trinitrobenzene
3h-tetracycline	3h-tetracycline
be_melanoma	be melanoma
1-alpha-d3	1-alpha-d3
4-hil	4-hil
1-hydroxyvitamin_d	1-hydroxyvitamin d
3-alpha-methyl-digitoxigenin_glucoside	3-alpha-methyl-digitoxigenin glucoside
20-methylcholanthrene	20-methylcholanthrene
prematurity	prematurity
primary_tumor	primary tumor
squamous_cell_carcinomas_of_the_thoracic_esophagus	squamous cell carcinomas of the thoracic esophagus
3-hydroxy-3-methylglutaric_acid	3-hydroxy-3-methylglutaric acid
anemia	anemia
mps	mps
cervical_lesions	cervical lesions
12-o-tetradecanoyl-1,2-phorbol_13-acetate	12-o-tetradecanoyl-1,2-phorbol 13-acetate
2-ethylcyclohexanone	2-ethylcyclohexanone
5-aminoisoquinoline	5-aminoisoquinoline
2-piminidazole	2-piminidazole
carcinosarcoma	carcinosarcoma
acute_skeletal_fluorosis	acute skeletal fluorosis
menopausal_vasomotor_symptoms	menopausal vasomotor symptoms
2-methylfuran	2-methylfuran
25oh-vitamin_d3	25oh-vitamin d3
multicarboxylase_deficiency	multicarboxylase deficiency
14c-normetanephrine	14c-normetanephrine
psychiatric	psychiatric
prostate_tumor	prostate tumor
adrenal_hyperplasia	adrenal hyperplasia
48740rp	48740rp
urogenital_symptoms	urogenital symptoms
4-demethoxydaunorubicin	4-demethoxydaunorubicin
ip	ip
hypoxia-ischaemia	hypoxia-ischaemia
nafld	nafld
2,6-dichlorobenzonitrile	2,6-dichlorobenzonitrile
2-phenylindole-3-carbaldehydes	2-phenylindole-3-carbaldehydes
10-gingerol	10-gingerol
thyroid_dysfunction	thyroid dysfunction
genetic_determinants	genetic determinants
20-fluoro-6,7-methylenedioxy-2-phenyl-4-quino-lone	20-fluoro-6,7-methylenedioxy-2-phenyl-4-quino-lone
12,13-epoxyoctadecenoic_acid	12,13-epoxyoctadecenoic acid
1,2,3-triazole	1,2,3-triazole
5-adc	5-adc
17beta-oestradiol	17beta-oestradiol
liver_enlargement	liver enlargement
lewy_body_dementia	lewy body dementia
nasal_inverted_papilloma	nasal inverted papilloma
myelomonocytic_wehi-3b_leukemia	myelomonocytic wehi-3b leukemia
3-hydroxy-3-methylglutaric	3-hydroxy-3-methylglutaric
3-cl-ahpc	3-cl-ahpc
3_a-aminocholestane	3 a-aminocholestane
11c	11c
1,5-diheteroarylpenta-1,4-dien-3-one	1,5-diheteroarylpenta-1,4-dien-3-one
ers	ers
t_cell_transfer_colitis	t cell transfer colitis
2-chloroprocaine	2-chloroprocaine
16-amino-acid	16-amino-acid
ischemic_neurologic_injury	ischemic neurologic injury
123i-tyr-3-octreotide	123i-tyr-3-octreotide
27-ohc	27-ohc
1,4,5-ip3	1,4,5-ip3
3-nitropropanoic_acid	3-nitropropanoic acid
3,5-dimethoxy_and_3,4,5-trimethoxy	3,5-dimethoxy and 3,4,5-trimethoxy
3-phenyl-1-propanol	3-phenyl-1-propanol
embryonal_carcinoma	embryonal carcinoma
5,7-dichlorokynurenic_acid	5,7-dichlorokynurenic acid
aps	aps
12-0-tetradecanoyl_phorbol_13_acetate	12-0-tetradecanoyl phorbol 13 acetate
1-mcg	1-mcg
2-amino-7-phosphonoheptanoic_acid	2-amino-7-phosphonoheptanoic acid
14c_alpha-amino-isobutyric_acid	14c alpha-amino-isobutyric acid
4-thiaflavanes	4-thiaflavanes
all	all
ischemic_lesion	ischemic lesion
spinal_cord_ischemia	spinal cord ischemia
1,2-dioleoyl-3-trimethylammonium-propane	1,2-dioleoyl-3-trimethylammonium-propane
age-related_macular_degeneration	age-related macular degeneration
4f-pcc	4f-pcc
3npa	3npa
3-n-butylphthalide	3-n-butylphthalide
15-deoxy-delta-12,14-prostaglandin_j2	15-deoxy-delta-12,14-prostaglandin j2
melasma	melasma
pazepc	pazepc
4-methylumbelliferyl_glucoside	4-methylumbelliferyl glucoside
vaginal_atrophy	vaginal atrophy
1-alpha-acetylmethadol	1-alpha-acetylmethadol
1542cp3tx	1542cp3tx
1-oleoyl-2-acetyl-glycerol	1-oleoyl-2-acetyl-glycerol
1-methyladenine	1-methyladenine
25hc3s	25hc3s
4-methylcatechol	4-methylcatechol
liver_carcinoma	liver carcinoma
2abi	2abi
pain_palliation	pain palliation
1e8	1e8
intracranial_meningioma	intracranial meningioma
bone_disorders	bone disorders
17-alpha-hydroxyprogesterone_caproate	17-alpha-hydroxyprogesterone caproate
2,4-dichlorophenoxyacetic_acid	2,4-dichlorophenoxyacetic acid
2-dimensional	2-dimensional
1,3-b-d-glucan	1,3-b-d-glucan
accidental_hypothermia	accidental hypothermia
airway_diseases	airway diseases
lingual_cancer	lingual cancer
vulvar_intraepithelial_neoplasia	vulvar intraepithelial neoplasia
degeneration_of_possible_serotonergic_nerves	degeneration of possible serotonergic nerves
squamous_cell_cancer	squamous cell cancer
neuron_damage	neuron damage
1,2-dimethylhydrazine_dihydrochloride	1,2-dimethylhydrazine dihydrochloride
15-methyl_prostaglandin_f2_alpha	15-methyl prostaglandin f2 alpha
201tl-chloride	201tl-chloride
1,4-butanediol	1,4-butanediol
bladder_tumorigenesis	bladder tumorigenesis
pancreatic_insulinoma	pancreatic insulinoma
18-ohb	18-ohb
4-tert-butyltoluene	4-tert-butyltoluene
3h-mp	3h-mp
1-deprenyl	1-deprenyl
copd	copd
hypothyroidism	hypothyroidism
fatty_liver	fatty liver
2-aminoethyl_diphenylborinate	2-aminoethyl diphenylborinate
byler_disease	byler disease
3h-1,25-dihydroxyvitamin_d3	3h-1,25-dihydroxyvitamin d3
2-substituted_1-naphthamides	2-substituted 1-naphthamides
circulatory_failure	circulatory failure
3,5-dimethoxy-4-hydroxybenzoic_acid	3,5-dimethoxy-4-hydroxybenzoic acid
excess_toxicity	excess toxicity
3-hydroxypyridine_succinate	3-hydroxypyridine succinate
escc_mouse	escc mouse
2hiv	2hiv
4,7-dihydroxycoumarin	4,7-dihydroxycoumarin
124-amino-acid	124-amino-acid
1,2-trans-dicarboxy-4,5-cyclohexanediols_1-3	1,2-trans-dicarboxy-4,5-cyclohexanediols 1-3
2,4-d_butylate	2,4-d butylate
3-substituted_aryl_oxindole	3-substituted aryl oxindole
h1n1_infection	h1n1 infection
autism_spectrum_disorder	autism spectrum disorder
startle	startle
18f-fet	18f-fet
learning_and_memory_deficits	learning and memory deficits
sci	sci
hep-g2_hepatocellular_carcinoma	hep-g2 hepatocellular carcinoma
125-iodine	125-iodine
basal_cell_carcinoma	basal cell carcinoma
bone_loss	bone loss
behavioral_depression	behavioral depression
necrotic	necrotic
203hg-hydroxy-mercury-fluorescein	203hg-hydroxy-mercury-fluorescein
14,674_bisphosphonate	14,674 bisphosphonate
maternal_aggression	maternal aggression
hypoplasia	hypoplasia
123i-15-iodophenyl_3-methyl_pentadecanoic_acid	123i-15-iodophenyl 3-methyl pentadecanoic acid
cardiac_dysfunction	cardiac dysfunction
3h-methylprednisolone	3h-methylprednisolone
400-425g	400-425g
4-ipomenaol	4-ipomenaol
colorectal_liver_metastases	colorectal liver metastases
chronic_renal_disease	chronic renal disease
hep-g2	hep-g2
10398a	10398a
impairment_of_lipoglycoprotein_metabolism	impairment of lipoglycoprotein metabolism
orbital_lymphoid_tumor	orbital lymphoid tumor
pms	pms
axis	axis
testicular_lesions	testicular lesions
2,4-thiazolidinedione	2,4-thiazolidinedione
acute_necrotizing_pancreatitis	acute necrotizing pancreatitis
3_beta-hydroxysteroid	3 beta-hydroxysteroid
17beta-estradiol-3-benzoate	17beta-estradiol-3-benzoate
2-deoxy-d-glucose	2-deoxy-d-glucose
17-allylamino-17-demethoxy-geldanamycin	17-allylamino-17-demethoxy-geldanamycin
tb	tb
autosomal_dominant_polycystic_kidney_disease	autosomal dominant polycystic kidney disease
4-amino-salicylic_acid	4-amino-salicylic acid
tubulointerstitial_nephritis	tubulointerstitial nephritis
ohd	ohd
2-methylbutyrate	2-methylbutyrate
12-acetoxyhawtriwaic_acid_lactone	12-acetoxyhawtriwaic acid lactone
breast_carcinogenesis	breast carcinogenesis
3ab	3ab
3,4-methylenedioxymethamphetamine	3,4-methylenedioxymethamphetamine
1,1,2-trisubstituted-1h-indenes	1,1,2-trisubstituted-1h-indenes
coeliac_disease	coeliac disease
5-aminolaevlinic_acid_methylester	5-aminolaevlinic acid methylester
hemolytic_anemia	hemolytic anemia
4-aminopteroylglutamic_acid	4-aminopteroylglutamic acid
learning_deficits	learning deficits
3mi	3mi
hirsutism	hirsutism
10-hda	10-hda
congenital_adrenal_hyperplasia	congenital adrenal hyperplasia
1-nitrosopiperidine	1-nitrosopiperidine
uc	uc
17-dd	17-dd
wt	wt
allodynia	allodynia
catalytic_reduction	catalytic reduction
erythema_nodosum-like_skin_lesions	erythema nodosum-like skin lesions
surgical_menopause	surgical menopause
glucose_insufficiency	glucose insufficiency
neuroleptic-naive-schizophrenia	neuroleptic-naive-schizophrenia
25-dihydroxyvitamin_d3	25-dihydroxyvitamin d3
cardiac_arrest	cardiac arrest
4-hydroxyltamoxifen	4-hydroxyltamoxifen
166ho-1,4,7,10-tetraazacyclododecane-1,4,7,10-tetramethylene-phosphonic_acid	166ho-1,4,7,10-tetraazacyclododecane-1,4,7,10-tetramethylene-phosphonic acid
tumour	tumour
3-daus	3-daus
colon_cancer	colon cancer
incomplete_bladder_emptying	incomplete bladder emptying
brain_damage	brain damage
2-methylbenzoylglycine	2-methylbenzoylglycine
20-hydroxyecdysone	20-hydroxyecdysone
ros	ros
malignant_granular_cell_tumor	malignant granular cell tumor
123i-iolopride	123i-iolopride
2,5-dimethylphenol	2,5-dimethylphenol
hiv-infected	hiv-infected
1,2-dioctanoyl-sn-glycerol	1,2-dioctanoyl-sn-glycerol
renal_injury_and_dysfunction	renal injury and dysfunction
17-ketosteroids	17-ketosteroids
2,3-dimercaptosuccinic_acid	2,3-dimercaptosuccinic acid
1,3-butadiene	1,3-butadiene
1400w	1400w
diffuse_midline_gliomas	diffuse midline gliomas
3_mu	3 mu
adhd	adhd
1,2,3,4-butanetetracarboxylic_acid	1,2,3,4-butanetetracarboxylic acid
pancreatic_hepatocytes	pancreatic hepatocytes
brain_dysfunction	brain dysfunction
pleural_effusions	pleural effusions
multiple_myeloma	multiple myeloma
adhesion	adhesion
2-heptanone	2-heptanone
skin_melanoma	skin melanoma
thymoma	thymoma
hyperprolactinemia	hyperprolactinemia
temporary_hypothermia	temporary hypothermia
thyroid_lesions	thyroid lesions
non-melanoma_skin_cancers	non-melanoma skin cancers
catalyzed_by_beta-galactosidase	catalyzed by beta-galactosidase
rrf	rrf
2-hydroxyquinoxaline	2-hydroxyquinoxaline
22q11ds	22q11ds
aggressiveness	aggressiveness
4sc-101	4sc-101
11-hocs	11-hocs
nephrosclerosis	nephrosclerosis
111in-rp748	111in-rp748
3-pga	3-pga
3,4-dihydroxyphenylethanol-elenolic_acid_dialdehyde	3,4-dihydroxyphenylethanol-elenolic acid dialdehyde
4-guanidinomethylbenzoic_acid_arylamides	4-guanidinomethylbenzoic acid arylamides
4-ohne	4-ohne
2-aminotetralines	2-aminotetralines
3-methoxy-4-propargyloxycinnamoyl_anthranilate	3-methoxy-4-propargyloxycinnamoyl anthranilate
clonic_seizures	clonic seizures
ich	ich
2-oh-saclofen	2-oh-saclofen
25-hydroxy-vitamin_d3	25-hydroxy-vitamin d3
craniofacial_defects	craniofacial defects
klebsiella_pneumoniae_hsl4	klebsiella pneumoniae hsl4
behavioral_damage	behavioral damage
3h-25-oxycholecalciferol	3h-25-oxycholecalciferol
2-ohe	2-ohe
2-np	2-np
weight_gain	weight gain
2-eha	2-eha
1-methylthio-3-pentanone	1-methylthio-3-pentanone
3-aipta	3-aipta
restenosis	restenosis
2d-pc-mra	2d-pc-mra
chronic_heart_failure	chronic heart failure
overdoses	overdoses
1,4-dimethylphenanthrene	1,4-dimethylphenanthrene
subacute_skeletal_myopathy	subacute skeletal myopathy
malignant_glioma	malignant glioma
1-piperonylpiperazine	1-piperonylpiperazine
3h-r_1881	3h-r 1881
lymphoid_malignancies	lymphoid malignancies
parkinsonian-type_syndrome	parkinsonian-type syndrome
ssi	ssi
autonomic_dysfunction	autonomic dysfunction
131i-6beta-iodomethyl-19-norcholesterol	131i-6beta-iodomethyl-19-norcholesterol
blastocysts	blastocysts
basal_ganglia_degeneration	basal ganglia degeneration
2,4,6-trinitro-benzenesulfonic_acid	2,4,6-trinitro-benzenesulfonic acid
multisystem_disease	multisystem disease
153sm-edtmp	153sm-edtmp
1,4-dihydropyridine	1,4-dihydropyridine
minimal_hepatic_encephalopathy	minimal hepatic encephalopathy
3-benzylidene-4-chromanones	3-benzylidene-4-chromanones
familial_hypercholesterolaemia	familial hypercholesterolaemia
sces	sces
125i-tu	125i-tu
4ohcp	4ohcp
fractures_of_the_femoral_neck	fractures of the femoral neck
2,6-dichloro-p-phenylenediamine	2,6-dichloro-p-phenylenediamine
2,3-benzodiazepine-4-one	2,3-benzodiazepine-4-one
4-14c-cholesterol	4-14c-cholesterol
cytotoxicity	cytotoxicity
4-amino-tetrahydro-l-biopterine	4-amino-tetrahydro-l-biopterine
anoestrous_ewes	anoestrous ewes
5,7-dht	5,7-dht
1-octadecanethiol	1-octadecanethiol
epstein-barr_virus	epstein-barr virus
2,4-dcp	2,4-dcp
1-phenyl-2-decanolyamino-3-morpholino-1-propanol	1-phenyl-2-decanolyamino-3-morpholino-1-propanol
12-o-tetradecanoyl-phorbol_13-acetate	12-o-tetradecanoyl-phorbol 13-acetate
mdi	mdi
13c-ubt	13c-ubt
cvd	cvd
12-0-tetradecanoyl-phorbol-13-acetate	12-0-tetradecanoyl-phorbol-13-acetate
php	php
2,4-diaminoazobenzene-n4-sulfanilamide	2,4-diaminoazobenzene-n4-sulfanilamide
2-hydroxyethyl_methacrylate	2-hydroxyethyl methacrylate
cold_allodynia	cold allodynia
acute_nonlymphoblastic_leukemia	acute nonlymphoblastic leukemia
tle	tle
3-monohydroxycholanie_acid	3-monohydroxycholanie acid
hypocalcemia	hypocalcemia
2-cyano-3,12-dioxoolean-1,9-dien-28-oic_acid	2-cyano-3,12-dioxoolean-1,9-dien-28-oic acid
1-cp-u	1-cp-u
occlusive_cerebrovascular_disease	occlusive cerebrovascular disease
13nh3-pet	13nh3-pet
bilateral_hyperaldosteronism	bilateral hyperaldosteronism
4hpr	4hpr
fgr	fgr
1alpha-hydroxy_vitamin_d3	1alpha-hydroxy vitamin d3
ftc	ftc
5-asa	5-asa
motor_defects	motor defects
17_beta-hydroxy-c19-steroid	17 beta-hydroxy-c19-steroid
1,3,5-trioxetanetrione	1,3,5-trioxetanetrione
5,6-dihydroxyindole-2-carboxylic_acid	5,6-dihydroxyindole-2-carboxylic acid
2-cba	2-cba
1,3-dp-melphalan	1,3-dp-melphalan
4-aminoquinolines_chloroquine	4-aminoquinolines chloroquine
3-hydroxy-3-methylgutaryl-coenzyne_a	3-hydroxy-3-methylgutaryl-coenzyne a
lupus_nephritis	lupus nephritis
1-ebio	1-ebio
gastrointestinal_stromal_tumor	gastrointestinal stromal tumor
encephalitis	encephalitis
cardiac_angiosarcoma	cardiac angiosarcoma
2-phenylethynesulfonamide	2-phenylethynesulfonamide
18-f-fluorodeoxyglucose	18-f-fluorodeoxyglucose
hypothalamus	hypothalamus
3-mtp	3-mtp
congenital_osteopetrosis	congenital osteopetrosis
macular_degeneration	macular degeneration
4-chloro-2-hydroxybenzoic-acid-n-butylamide	4-chloro-2-hydroxybenzoic-acid-n-butylamide
renal_cell_carcinoma	renal cell carcinoma
dystrophy	dystrophy
megakaryoblastic_leukemia	megakaryoblastic leukemia
2-nitroso-n-arylanilines	2-nitroso-n-arylanilines
4-aminopyridine	4-aminopyridine
oral_squamous_carcinoma	oral squamous carcinoma
4-dimethylaminophenol	4-dimethylaminophenol
myelin_damage	myelin damage
123i-iodoazomycin_arabinoside	123i-iodoazomycin arabinoside
2-hdp	2-hdp
renal_disease	renal disease
hyperalgesia	hyperalgesia
4-xl-ppd	4-xl-ppd
1-phenylisopropyladenosine	1-phenylisopropyladenosine
cutaneous_squamous_cell_carcinoma	cutaneous squamous cell carcinoma
ataxia_telangiectasia	ataxia telangiectasia
4-vinyl-1-cyclohexene_diepoxide	4-vinyl-1-cyclohexene diepoxide
myocardial_sympathetic_dysfunction	myocardial sympathetic dysfunction
liver_regeneration	liver regeneration
colorectal_cancer	colorectal cancer
1-sar-8-ile-angiotensin_ii	1-sar-8-ile-angiotensin ii
endometriosis	endometriosis
cataracts	cataracts
1-palmitoyl-2-arachidonyl-sn-glycerol-3-phosphocholine	1-palmitoyl-2-arachidonyl-sn-glycerol-3-phosphocholine
pancreas_cancer	pancreas cancer
spd	spd
osteopenia	osteopenia
mcf	mcf
4-mercaptobiphenyls	4-mercaptobiphenyls
1-methylpropyl_2-imidazolyl_disulfide	1-methylpropyl 2-imidazolyl disulfide
2-chloro-deoxyadenosine	2-chloro-deoxyadenosine
cad	cad
16-iodo-3-methylhexadecanoic_acid	16-iodo-3-methylhexadecanoic acid
17_beta-oestradiol	17 beta-oestradiol
cardiac_hypertrophy	cardiac hypertrophy
18-methoxycoronaridine	18-methoxycoronaridine
necturus_gallbladder	necturus gallbladder
ototoxicity	ototoxicity
13762a	13762a
constipation	constipation
3-phenylpropyl_isobutyrate	3-phenylpropyl isobutyrate
eps	eps
l-2-hydroxyglutaric_aciduria	l-2-hydroxyglutaric aciduria
malignant_hyperthermia	malignant hyperthermia
15-methyl_prostaglandin_f2alpha	15-methyl prostaglandin f2alpha
cutaneous_t-cell_lymphoproliferative_disorders	cutaneous t-cell lymphoproliferative disorders
fabric_occlusion	fabric occlusion
neoplasms	neoplasms
adenomas	adenomas
4-ipomeanol	4-ipomeanol
11c-choline_positron	11c-choline positron
3-monochloropropane-1,2-diol	3-monochloropropane-1,2-diol
10-chlorodeserpidine	10-chlorodeserpidine
essential_mixed_cryoglobulinemia	essential mixed cryoglobulinemia
3_alpha-androstanediol	3 alpha-androstanediol
1,25-dihydroxy-vitamin_d3	1,25-dihydroxy-vitamin d3
ibd	ibd
at	at
affective_disorders	affective disorders
3-phosphonopropionic_acid	3-phosphonopropionic acid
3_alpha-dihydrocadambine	3 alpha-dihydrocadambine
active_disease	active disease
15d2-d3	15d2-d3
3-hydroxyanthranilic_acid	3-hydroxyanthranilic acid
cerebral_infarct_volume	cerebral infarct volume
12-o-tetradecanoyl_phorbol_13-acetate	12-o-tetradecanoyl phorbol 13-acetate
3h-glucose	3h-glucose
ovarian_cystadenocarcinoma	ovarian cystadenocarcinoma
1,2,3,4-tetrahydro-1-acridone	1,2,3,4-tetrahydro-1-acridone
pediatric_brain_tumor	pediatric brain tumor
inhalation_toxicity	inhalation toxicity
unimolecular_dissociation	unimolecular dissociation
3-amino-methyl-3,5,5-trimethylcyclohexylamine	3-amino-methyl-3,5,5-trimethylcyclohexylamine
2-methyl-4-phenylpentanol	2-methyl-4-phenylpentanol
2-bromoethanamine	2-bromoethanamine
2-allyloxy-3-methylbenzamide	2-allyloxy-3-methylbenzamide
12a-hydroxyrotenone	12a-hydroxyrotenone
17_beta-estradiol_3	17 beta-estradiol 3
hsv-2_infection	hsv-2 infection
4-damp	4-damp
gastrinoma	gastrinoma
2-chloroethylamine	2-chloroethylamine
behavioral_problems	behavioral problems
peripheral_t-cell_lymphoma	peripheral t-cell lymphoma
21-aminosteroids	21-aminosteroids
177lu-labeled_immunoconjugate	177lu-labeled immunoconjugate
phenylketonuria	phenylketonuria
gsdi	gsdi
liver_cysts	liver cysts
oavs	oavs
cognitive_enhancer	cognitive enhancer
1,2-dithiole-3-thione	1,2-dithiole-3-thione
1,4-di-n-oxide-quinoxaline-2-ylmethylene_isonicotinic_acid_hydrazide	1,4-di-n-oxide-quinoxaline-2-ylmethylene isonicotinic acid hydrazide
2,4-dinitrofluorobenzene	2,4-dinitrofluorobenzene
preterm_birth	preterm birth
follicular_lymphomas	follicular lymphomas
4-phenyl-butyric_acid	4-phenyl-butyric acid
wm	wm
di	di
2,4,6-trinitrobenzenesulphonic_acid	2,4,6-trinitrobenzenesulphonic acid
2-4-dinitrochlorobenzene	2-4-dinitrochlorobenzene
4-aminobutyric_acid	4-aminobutyric acid
cqds	cqds
hemophilia_a	hemophilia a
25-hydroxycholecalciferol	25-hydroxycholecalciferol
2-dimethylamino-4,5,6,7-tetrabromobenzimidazole	2-dimethylamino-4,5,6,7-tetrabromobenzimidazole
14c-glycocholate	14c-glycocholate
hs	hs
17_b-estradiol	17 b-estradiol
antioxidant_activity	antioxidant activity
oscc	oscc
14c-cholic_acid	14c-cholic acid
chronic_hepatitis_delta_virus_infection	chronic hepatitis delta virus infection
attenuated_iir_injury	attenuated iir injury
24s-hydroxycholesterol	24s-hydroxycholesterol
planar_structure	planar structure
intra-oral_palatal_squamous_cell_carcinomas	intra-oral palatal squamous cell carcinomas
myocardial_stunning	myocardial stunning
human_glioma	human glioma
2-cyclohexyl-1,6-heptadien-3-one	2-cyclohexyl-1,6-heptadien-3-one
malignancy	malignancy
2-hydroxyglutaric_aciduria	2-hydroxyglutaric aciduria
18-fluorodexoyglucose	18-fluorodexoyglucose
pca	pca
2-fluoroacetamide	2-fluoroacetamide
3-5-fold	3-5-fold
2,5-disubstituted_pyrimidine	2,5-disubstituted pyrimidine
18f-fdg-pet	18f-fdg-pet
1-butyl-3-methylimidazolium_salicylate	1-butyl-3-methylimidazolium salicylate
1,25-vitamin_d	1,25-vitamin d
17-demethoxygeldanamycin	17-demethoxygeldanamycin
2-nitroimidazooxazine	2-nitroimidazooxazine
18:0-oh	18:0-oh
4,5-dihydroxy-3-methyl-cyclohex-2-enone	4,5-dihydroxy-3-methyl-cyclohex-2-enone
1,1,1-trichloroethane	1,1,1-trichloroethane
17-hydroxysteroids	17-hydroxysteroids
peripheral_neuropathy	peripheral neuropathy
obese	obese
4-ap-sr	4-ap-sr
3-amino-2-hydroxy-4-phenyl-valyl-isoleucine	3-amino-2-hydroxy-4-phenyl-valyl-isoleucine
rat_osteosarcoma	rat osteosarcoma
1-ethyl-1-nitrosourea	1-ethyl-1-nitrosourea
3-nitrotyrosine	3-nitrotyrosine
5,7-dihydroxy-3,6,8-trimethoxy-2-phenyl-4h-chromen-4-one	5,7-dihydroxy-3,6,8-trimethoxy-2-phenyl-4h-chromen-4-one
3h-serotonin	3h-serotonin
1,6-diene	1,6-diene
3h-androstenedione	3h-androstenedione
atheroma	atheroma
crf	crf
hepatoblastoma	hepatoblastoma
hypomyelinating	hypomyelinating
17alpha-hydroxyprogesterone_caproate	17alpha-hydroxyprogesterone caproate
15-methyl-pgf2_alpha_methyl_ester	15-methyl-pgf2 alpha methyl ester
2dcf	2dcf
acute_diverticulitis	acute diverticulitis
24-hydroxycholesterol	24-hydroxycholesterol
1-methyl-4-phenyl-1,2,3-6-tetrahydropyridine	1-methyl-4-phenyl-1,2,3-6-tetrahydropyridine
11c-n-methylspiperone	11c-n-methylspiperone
x-ray_diffraction	x-ray diffraction
2-secd	2-secd
4kb5	4kb5
hematologic_malignancies	hematologic malignancies
14-deacetyleurylene	14-deacetyleurylene
2,3,7,8-tetrachlorodibenzo-p-dioxin	2,3,7,8-tetrachlorodibenzo-p-dioxin
2-carba-cyclic_phosphatidic_acid	2-carba-cyclic phosphatidic acid
17alpha-ethinyl_estradiol	17alpha-ethinyl estradiol
2-h_glucose	2-h glucose
analgesia	analgesia
18f_choline	18f choline
diabetics	diabetics
4-ap	4-ap
4-hydroxy_cinnamic_acid	4-hydroxy cinnamic acid
3-lysine-27-methionine	3-lysine-27-methionine
colitis-associated_neoplasia	colitis-associated neoplasia
anxiety	anxiety
3h-qnb_and_3h-pirenzepine	3h-qnb and 3h-pirenzepine
ais	ais
1-diethylcarbamyl-4-methylpiperazine_hydrochloride	1-diethylcarbamyl-4-methylpiperazine hydrochloride
multiple_trauma	multiple trauma
pulmonary_adenocarcinomas	pulmonary adenocarcinomas
lacunar_stroke	lacunar stroke
12-o-tetradecanolyphorbol-13-acetate	12-o-tetradecanolyphorbol-13-acetate
cooperia_punctata	cooperia punctata
1h	1h
18o2	18o2
5-aminosalicylic_acid	5-aminosalicylic acid
1,1-dichloroethylene_epoxide	1,1-dichloroethylene epoxide
urinary_bladder_carcinoma	urinary bladder carcinoma
4-n-butylresorcinol	4-n-butylresorcinol
neuro-inflammation	neuro-inflammation
cem	cem
inhibitor_of_long-chain_acylcarnitine_transferase-i	inhibitor of long-chain acylcarnitine transferase-i
esft	esft
3,4-didehydroretinol	3,4-didehydroretinol
3-dg	3-dg
lung_carcinoma	lung carcinoma
4-hydroxy-2,2,6,6-tetramethylpiperidene-1-oxyl	4-hydroxy-2,2,6,6-tetramethylpiperidene-1-oxyl
2,3,5-triphenyltetrazolium_hydrochloride	2,3,5-triphenyltetrazolium hydrochloride
esophageal_cancer	esophageal cancer
35s_lipoic_acid	35s lipoic acid
metastasis	metastasis
27-hc	27-hc
malignant_tracheal_tumor	malignant tracheal tumor
1,2,4-trichlorobenzene	1,2,4-trichlorobenzene
sister_chromatid_exchanges	sister chromatid exchanges
stroke	stroke
3,5-dimethoxyphenol	3,5-dimethoxyphenol
metabolic_disposition	metabolic disposition
1,3-dag	1,3-dag
3-hydroxyisovalerylcarnitine	3-hydroxyisovalerylcarnitine
2-methylpropylene_diol	2-methylpropylene diol
14,15-epoxyeicosatrienoic_acid	14,15-epoxyeicosatrienoic acid
pgs	pgs
dermatologic_disorders	dermatologic disorders
estrogen_deficiency	estrogen deficiency
renal_dysfunction	renal dysfunction
periodontal_disease	periodontal disease
2-c14_urate	2-c14 urate
ws	ws
3cl-tyr	3cl-tyr
molecular_imprinted_polymer	molecular imprinted polymer
3,4_dimethoxyphenylethylamine	3,4 dimethoxyphenylethylamine
renal_diseases	renal diseases
low_grade_lymphoma	low grade lymphoma
2-aryl_benzimidazole	2-aryl benzimidazole
very_low-risk_prostate_cancer	very low-risk prostate cancer
3-hydroxymethyl-3-glutaryl-coa	3-hydroxymethyl-3-glutaryl-coa
1,6-hexanediol_diacrylate	1,6-hexanediol diacrylate
2-amino-5-nitrophenol	2-amino-5-nitrophenol
2-tert-butyl-1,4-benzoquinone	2-tert-butyl-1,4-benzoquinone
hemorrhagic_shock	hemorrhagic shock
ear_swellings	ear swellings
typical_polycystic_ovary_syndrome	typical polycystic ovary syndrome
aki	aki
copper_nanoparticles	copper nanoparticles
3h-da	3h-da
nbccs	nbccs
ketonuria	ketonuria
3-hexylsulfanyl-pyrazin-2-yloxy	3-hexylsulfanyl-pyrazin-2-yloxy
pulmonary_tuberculosis	pulmonary tuberculosis
muscle_atrophy	muscle atrophy
lymphoblastic_leukaemia	lymphoblastic leukaemia
3-hpma	3-hpma
1-methylxanthine	1-methylxanthine
mmc_cytotoxicity	mmc cytotoxicity
hoga1_deficiency	hoga1 deficiency
renal_impairment	renal impairment
postischemic_microvascular_damage	postischemic microvascular damage
acute_nonlymphocytic_leukemia	acute nonlymphocytic leukemia
oesophageal_adenocarcinoma	oesophageal adenocarcinoma
3,4-epoxybutane	3,4-epoxybutane
inflammatory_joint_diseases	inflammatory joint diseases
hf	hf
11-dehydro-txb2	11-dehydro-txb2
2-hydroxyoleic_acid	2-hydroxyoleic acid
1,2-dce	1,2-dce
fibrosarcomas	fibrosarcomas
hnc	hnc
initial_changes_of_rat_leukemia	initial changes of rat leukemia
cml	cml
1-phenylisatin	1-phenylisatin
gdm	gdm
23bd	23bd
mammary_carcinoma	mammary carcinoma
hepatic_encephalopathy	hepatic encephalopathy
1-methyl-4-phenyl-pyridinium	1-methyl-4-phenyl-pyridinium
ovarian_surface_epithelium	ovarian surface epithelium
congestive_heart_failure	congestive heart failure
helicobacter_pylori_infection_of_gastric_mucosa	helicobacter pylori infection of gastric mucosa
brain_inflammation	brain inflammation
25,26-dihydroxycholecalciferol	25,26-dihydroxycholecalciferol
2,5-dimethylfuran	2,5-dimethylfuran
4ma	4ma
neuroepithelial_tumors	neuroepithelial tumors
liver_cirrhosis	liver cirrhosis
atherosclerosis	atherosclerosis
diabetic_neuropathy	diabetic neuropathy
3-methylsulfonyl-dde	3-methylsulfonyl-dde
12-hete	12-hete
subcutaneous_mac15a_tumours	subcutaneous mac15a tumours
1,2-dibromoethane	1,2-dibromoethane
progressive_massive_fibrosis	progressive massive fibrosis
4-pba	4-pba
3hc-glucuronide	3hc-glucuronide
ovarian_adenocarcinoma	ovarian adenocarcinoma
17-alpha-thioestradiol	17-alpha-thioestradiol
3nt	3nt
12-dhgd	12-dhgd
2,4-hexadienal	2,4-hexadienal
pancreatic_carcinoma	pancreatic carcinoma
dlbcl	dlbcl
3-aminophthal-hydrazide	3-aminophthal-hydrazide
cardiac_arrhythmias	cardiac arrhythmias
melanoma_c-32_and_breast_cancer	melanoma c-32 and breast cancer
cp	cp
mtc	mtc
17-abag	17-abag
1,2,3-triazoles	1,2,3-triazoles
2-dichloromethylene_bisphosphonate	2-dichloromethylene bisphosphonate
advanced_renal_cell_carcinoma	advanced renal cell carcinoma
4-hydroxy-nonenal	4-hydroxy-nonenal
1,2:5,6-dianhydrogalactitol	1,2:5,6-dianhydrogalactitol
maids_infection	maids infection
chinese_hamster_ovary	chinese hamster ovary
aob	aob
18-hydroxydeoxycorticosterone	18-hydroxydeoxycorticosterone
18f-mfbg	18f-mfbg
gastric_damage	gastric damage
4aza1378	4aza1378
4-aminoquinolines	4-aminoquinolines
2-sulfanilamido-3-methoxypyridazine	2-sulfanilamido-3-methoxypyridazine
postmenopausal_osteoporosis	postmenopausal osteoporosis
3-methyl-1-phenyl-2-pyrazolin-5-one	3-methyl-1-phenyl-2-pyrazolin-5-one
1,3_dichloropropene	1,3 dichloropropene
17-b_estradiol	17-b estradiol
2-amino-4-arsonobutyrate	2-amino-4-arsonobutyrate
preeclampsia	preeclampsia
3h-estradiol	3h-estradiol
mediobasal_hypothalamus	mediobasal hypothalamus
lactotroph_hyperplasia	lactotroph hyperplasia
gestational_diabetes_insipidus	gestational diabetes insipidus
3-cp	3-cp
metaplastic_thymoma	metaplastic thymoma
2-phenyl-4-quionolone	2-phenyl-4-quionolone
non-small_cell_lung_carcinoma	non-small cell lung carcinoma
4-mp	4-mp
123i-heptadecanoic_acid	123i-heptadecanoic acid
14c-iodoantipyrine	14c-iodoantipyrine
iri	iri
cardiovascular_diseases	cardiovascular diseases
4-3-oxosteroid	4-3-oxosteroid
pseudophakic_eyes	pseudophakic eyes
pdc	pdc
oral_squamous_cell_carcinoma	oral squamous cell carcinoma
ado	ado
1-naphthoic_acid	1-naphthoic acid
spiral_ganglion_cell_degeneration	spiral ganglion cell degeneration
pkc	pkc
gep-tumours	gep-tumours
5-aminolevulinic_acid	5-aminolevulinic acid
5,6-dimethylxanthenone_4-acetic_acid	5,6-dimethylxanthenone 4-acetic acid
35s-methionine	35s-methionine
14c	14c
17-a-hydroxyprogesterone_caproate	17-a-hydroxyprogesterone caproate
macroglobulinemic_lymphoma	macroglobulinemic lymphoma
2-br-alpha-ergocryptine	2-br-alpha-ergocryptine
12-methyltridecanal	12-methyltridecanal
5ala	5ala
low_cardiac_output	low cardiac output
1-propanol	1-propanol
carcinomas	carcinomas
1-methylcyclopropene	1-methylcyclopropene
md	md
orthopedic_infections	orthopedic infections
4-trifluoromethylumbelliferyl-alpha-l-iduronide	4-trifluoromethylumbelliferyl-alpha-l-iduronide
vascular_tumors	vascular tumors
neurometabolic_disorder	neurometabolic disorder
3-indoipyruvate	3-indoipyruvate
25-hydroxyvitamin_d2	25-hydroxyvitamin d2
11c-choline	11c-choline
1-phenylcyclohexene	1-phenylcyclohexene
pulmonary_arterial_hypertension	pulmonary arterial hypertension
3-methoxy-4-hydroxymandelic_acid	3-methoxy-4-hydroxymandelic acid
parasitemia	parasitemia
1-o-hexadecyloxypropyl-cdv	1-o-hexadecyloxypropyl-cdv
characterization_of_olfactory_deficits	characterization of olfactory deficits
faster_fbp_consumption	faster fbp consumption
hypoxia	hypoxia
18f-dopa	18f-dopa
3,4-dap	3,4-dap
parathyroid_adenoma	parathyroid adenoma
renal_papillary_necrosis	renal papillary necrosis
dmd	dmd
4-t-op	4-t-op
4-app	4-app
3,4-dehydro-dl-proline	3,4-dehydro-dl-proline
hht	hht
amyloid-beta_and_tau_aggregation	amyloid-beta and tau aggregation
pseudotuberculosis	pseudotuberculosis
toxicosis	toxicosis
3-methoxy-4-hydroxyphenylethylene-glycol	3-methoxy-4-hydroxyphenylethylene-glycol
18-hydroxycorticosterone	18-hydroxycorticosterone
cirrhosis_of_the_liver	cirrhosis of the liver
weak_tumor	weak tumor
4-vo	4-vo
4-methoxy-5-hydroxycanthin-6-one	4-methoxy-5-hydroxycanthin-6-one
2brp	2brp
2,3-dimercapto-1-propanesulphonic_acid	2,3-dimercapto-1-propanesulphonic acid
4alpha-phorbol	4alpha-phorbol
acute_myocardial_ischemia	acute myocardial ischemia
aggressive	aggressive
14c_fotemustine	14c fotemustine
2-dodecyl-6-methoxycyclohexa-2,5-diene-1,4-dione	2-dodecyl-6-methoxycyclohexa-2,5-diene-1,4-dione
3beta-adiol	3beta-adiol
long-chain_hydroxyacylcarnitines_and_deficiencies	long-chain hydroxyacylcarnitines and deficiencies
5-amino-salicylic_acid	5-amino-salicylic acid
bl	bl
lupus_like_syndrome	lupus like syndrome
1-carboxamide	1-carboxamide
13-hode	13-hode
cerebral_hypoperfusion	cerebral hypoperfusion
2,3,7,8-tetrachlorodigenzo-p-dioxin	2,3,7,8-tetrachlorodigenzo-p-dioxin
af	af
10-hydroxy-2-decenoic_acid	10-hydroxy-2-decenoic acid
1-glutamic_acid	1-glutamic acid
10-ethyl-10-deazaaminopterin	10-ethyl-10-deazaaminopterin
11-hydroxycorticoid	11-hydroxycorticoid
detection_of_breast_disease	detection of breast disease
cerebral_blood_flow	cerebral blood flow
2-cpr	2-cpr
2,6-disubstituted_pyrazines	2,6-disubstituted pyrazines
human_osteoblasts	human osteoblasts
hypercalcemia	hypercalcemia
4cmenb	4cmenb
2dg	2dg
13-cis_retinoic_acid	13-cis retinoic acid
1,3,4-thiadiazine	1,3,4-thiadiazine
1,2-dihydroxyvitamin_d	1,2-dihydroxyvitamin d
inflammatory_bowel_disease	inflammatory bowel disease
3,4-methylenedioxy-b-nitrostyrene	3,4-methylenedioxy-b-nitrostyrene
occupational_disease	occupational disease
3-carboethoxy-beta-carboline_hydrochloride	3-carboethoxy-beta-carboline hydrochloride
phototoxicity	phototoxicity
2,4,5-trichlorophenoxyacetic_acid	2,4,5-trichlorophenoxyacetic acid
trichoblastic_carcinoma	trichoblastic carcinoma
2-pag	2-pag
cancers	cancers
17alpha_methyltestosterone	17alpha methyltestosterone
1,3-bdg	1,3-bdg
opscc	opscc
cerebral_arteriovenous_malformations	cerebral arteriovenous malformations
colorectal_tumours	colorectal tumours
hairy_cell_leukemia	hairy cell leukemia
12-0-tetradecanoylphorbol-13-acetate	12-0-tetradecanoylphorbol-13-acetate
cardiac_diseases	cardiac diseases
deficiency_of_the_kidney_isozyme	deficiency of the kidney isozyme
17dv	17dv
acute_promyelocytic_leukemia	acute promyelocytic leukemia
1-desamino-8-d-arginine-vasopressin	1-desamino-8-d-arginine-vasopressin
dyskinesia	dyskinesia
2-chloropyridine	2-chloropyridine
testicular_necrosis	testicular necrosis
12-0-tetradecanoyl-phorbol_13-acetate	12-0-tetradecanoyl-phorbol 13-acetate
57co-labeled_bleomycin	57co-labeled bleomycin
2-hydroxybenzoylglycine	2-hydroxybenzoylglycine
cancer	cancer
1,1-dichloroethylene	1,1-dichloroethylene
123i	123i
pituitary_tumour	pituitary tumour
3dg	3dg
252cf	252cf
clear_cell_renal_cell_carcinoma	clear cell renal cell carcinoma
alcohol_deprotection	alcohol deprotection
intestinal_carcinoids	intestinal carcinoids
1-o-hexadecyl-2-acetyl-sn-glycero-3-phosphorylcholine	1-o-hexadecyl-2-acetyl-sn-glycero-3-phosphorylcholine
rectal_tumors	rectal tumors
1-alpha-hydroxycholecalciferol	1-alpha-hydroxycholecalciferol
1,1-dichlorodiphenildichloroethane	1,1-dichlorodiphenildichloroethane
3-acyl-5-hydroxybenzofuran	3-acyl-5-hydroxybenzofuran
composite_neonatal_morbidity	composite neonatal morbidity
damage_to_serotonergic_axons_and_memory_impairment	damage to serotonergic axons and memory impairment
hl	hl
li	li
cryptococcal_meningitis	cryptococcal meningitis
1_alpha_hydroxycholecalciferol	1 alpha hydroxycholecalciferol
major_depressive_disorder	major depressive disorder
4-mercaptobenzenesulfonamide	4-mercaptobenzenesulfonamide
cs	cs
1-methy-4-phenyl-1,2,3,6-tetrahydropyridine	1-methy-4-phenyl-1,2,3,6-tetrahydropyridine
14c-orotic_acid	14c-orotic acid
myocardial_dysfunction	myocardial dysfunction
23-g	23-g
alf	alf
glucose_intolerance	glucose intolerance
male_rainbowfish	male rainbowfish
pco	pco
excitotoxic_lesions	excitotoxic lesions
condyloma_acuminatum	condyloma acuminatum
18f_fluorocholine	18f fluorocholine
androgenetic_alopecia	androgenetic alopecia
cardiotoxic	cardiotoxic
4-bromo-2,5-dimethoxyamphetamine	4-bromo-2,5-dimethoxyamphetamine
overdose	overdose
1-methyl-4-phenyl-1,2,3,4-tetrahydropyridine	1-methyl-4-phenyl-1,2,3,4-tetrahydropyridine
gastroduodenal_ulcers	gastroduodenal ulcers
3-mi	3-mi
growth_disorder	growth disorder
3b-diol	3b-diol
endothelium-derived_hyperpolarizing_factor	endothelium-derived hyperpolarizing factor
3_h-methotrexate	3 h-methotrexate
ogd	ogd
co_poisoning	co poisoning
4-hydroxybutyric_acid	4-hydroxybutyric acid
ruptured_achilles_tendon	ruptured achilles tendon
ihd	ihd
neuromuscular_block	neuromuscular block
4-hydroxy-3-nitro-2-quinolones	4-hydroxy-3-nitro-2-quinolones
demyelinating_neuropathies	demyelinating neuropathies
123i-5-ia-85380	123i-5-ia-85380
secondary_peritonitis	secondary peritonitis
psychosis	psychosis
crohn_disease	crohn disease
3du	3du
hypersensitivity_to_5-ht	hypersensitivity to 5-ht
1-methyl-4-phenyl-1,2,3,6_tetrahydropyridine	1-methyl-4-phenyl-1,2,3,6 tetrahydropyridine
2,3_diphosphoglycerate	2,3 diphosphoglycerate
arsa_deficiency	arsa deficiency
18f-2-deoxyglucose	18f-2-deoxyglucose
18-oh-doc	18-oh-doc
liver_ischemia	liver ischemia
1-chloro-2,4-dinitrobenzene	1-chloro-2,4-dinitrobenzene
myocarditis	myocarditis
5-aminolevulinic_acid_methyl_ester_hydrochloride	5-aminolevulinic acid methyl ester hydrochloride
skin_flap_necrosis	skin flap necrosis
18f-fluoro-2-deoxyglucose	18f-fluoro-2-deoxyglucose
brain_lesions	brain lesions
acute_myeloblastic_leukemia	acute myeloblastic leukemia
ligand_binding_domain	ligand binding domain
pneumocystis_carinii_pneumonia	pneumocystis carinii pneumonia
enlargement_of_the_liver	enlargement of the liver
head_injury	head injury
4-tertiary_butyl_phenol	4-tertiary butyl phenol
hypervitaminosis_d	hypervitaminosis d
cis	cis
18f-fluorocholine	18f-fluorocholine
14c-permethrin	14c-permethrin
3-oxa-analogue	3-oxa-analogue
gastric_tumor	gastric tumor
skin_carcinoma	skin carcinoma
13-mtd	13-mtd
uterine_sarcoma	uterine sarcoma
pdt	pdt
25-hydroxy-vitamin-d-3	25-hydroxy-vitamin-d-3
infection_of_kidney_cells	infection of kidney cells
24oh-ce	24oh-ce
hol	hol
myocardium	myocardium
tibia	tibia
femoral_fracture	femoral fracture
5aris	5aris
reducing_neointimal_hyperplasia	reducing neointimal hyperplasia
13c_acetate	13c acetate
acute_myocardial_infarction	acute myocardial infarction
177lu-psma	177lu-psma
gc	gc
pancreatic_necrosis	pancreatic necrosis
3-methylhistidine	3-methylhistidine
transhepatic_variceal_embolization	transhepatic variceal embolization
1,3-dichloropropene	1,3-dichloropropene
ischemia	ischemia
1-hydroxyvitamin_d3	1-hydroxyvitamin d3
4-methoxyequilenin	4-methoxyequilenin
5,6-dichloro-ribifuranosylbenzimidazole	5,6-dichloro-ribifuranosylbenzimidazole
1,6-hexamethylene_diisocyanate	1,6-hexamethylene diisocyanate
cardiovascular_disorders	cardiovascular disorders
1,4-dimethanesulfonyloxbutane	1,4-dimethanesulfonyloxbutane
17-ketosteroid	17-ketosteroid
25-oh-d	25-oh-d
cardiovascular_events	cardiovascular events
type_ii_fragmentation	type ii fragmentation
middle_cerebral_artery_occlusion	middle cerebral artery occlusion
3-carboxylic_acid	3-carboxylic acid
metabolic_acidosis	metabolic acidosis
18_f-fluorodeoxy-glucose	18 f-fluorodeoxy-glucose
aqueous_humor	aqueous humor
spiral_ganglion_neurons	spiral ganglion neurons
vernal_keratoconjunctivitis	vernal keratoconjunctivitis
cholangiolitic_hepatitis	cholangiolitic hepatitis
adenoma	adenoma
fungal_strain	fungal strain
fulminant_hepatic_failure	fulminant hepatic failure
b-pll	b-pll
1-naphthoxyacetic_acid	1-naphthoxyacetic acid
waldenstrom_macroglobulinemia	waldenstrom macroglobulinemia
25-hydroxy_vitd	25-hydroxy vitd
breast_carcinoma	breast carcinoma
4-methoxyphenol	4-methoxyphenol
pulmonary_aspergilloma	pulmonary aspergilloma
25-hydroxyvitamin	25-hydroxyvitamin
13c-methacetin	13c-methacetin
5ac	5ac
hyaluronan_synthesis_and_retards_cancer	hyaluronan synthesis and retards cancer
10b-bpa	10b-bpa
18-hydroxy-corticosterone	18-hydroxy-corticosterone
coronary_and_iliac_artery_injury	coronary and iliac artery injury
4-amino_pteroyl_glutamic_acid	4-amino pteroyl glutamic acid
13-cra	13-cra
3-hydroxy-3-methyl-glutaryl_coenzyme_a	3-hydroxy-3-methyl-glutaryl coenzyme a
1,3,6,7-tetrahydroxy-8-prenylxanthone	1,3,6,7-tetrahydroxy-8-prenylxanthone
2me2	2me2
eda	eda
sals	sals
tlrs	tlrs
neural_and_cardiac_toxicities	neural and cardiac toxicities
gynecomastia	gynecomastia
25-hydroxy_vitamin_d3	25-hydroxy vitamin d3
4-nitroquinaldine_n-oxide	4-nitroquinaldine n-oxide
1,4-disubstituted-1,2,3-triazole	1,4-disubstituted-1,2,3-triazole
bcr-abl-positive_leukemias	bcr-abl-positive leukemias
2,3,5,6-tetramethylpyrazine	2,3,5,6-tetramethylpyrazine
2,3,4,7,8-pecdf	2,3,4,7,8-pecdf
2,2-azinobis3-ethylbenzo-thiazoline-6-sulphonic_acid	2,2-azinobis3-ethylbenzo-thiazoline-6-sulphonic acid
2-methylcitric_acid	2-methylcitric acid
4dpg	4dpg
1-o-tetradecanoylphorbol-13-acetate	1-o-tetradecanoylphorbol-13-acetate
11c-sarcosine	11c-sarcosine
claudication	claudication
ovaries	ovaries
3-hydroxy-3-methylgutaryl_coa	3-hydroxy-3-methylgutaryl coa
24s-oh-chol	24s-oh-chol
lhermitte-duclos_disease	lhermitte-duclos disease
4-mba	4-mba
4-mercaptopyridine	4-mercaptopyridine
disinhibition	disinhibition
17-ohpc	17-ohpc
2-asd_ii	2-asd ii
heroin_dependence	heroin dependence
correlated_rotation	correlated rotation
2,3-benzodiazepines	2,3-benzodiazepines
2-pebp	2-pebp
excess_lung_tumors	excess lung tumors
2-hydroxyglutarate	2-hydroxyglutarate
rms	rms
rp	rp
attenuated_dopaminergic_neurodegeneration	attenuated dopaminergic neurodegeneration
2-butoxyacetic_acid	2-butoxyacetic acid
gastric_cancer	gastric cancer
4-dimethylaminoazobenzene	4-dimethylaminoazobenzene
zona_fasciculata	zona fasciculata
1-palmitoyl-2-azelaoyl-sn-glycero-3-phosphocholine	1-palmitoyl-2-azelaoyl-sn-glycero-3-phosphocholine
cerebral_melanoma_metastasis	cerebral melanoma metastasis
bone_mineral_density	bone mineral density
2na	2na
herpes_simplex_virus_infections	herpes simplex virus infections
223racl2	223racl2
2-chloroadenosine	2-chloroadenosine
25-hydroxy-vitamin_d	25-hydroxy-vitamin d
3brpyr	3brpyr
18f-2-deoxy-fluoro-d-glucose	18f-2-deoxy-fluoro-d-glucose
leukopenia	leukopenia
13-cis-ra	13-cis-ra
acute_ischemic_stroke	acute ischemic stroke
low-renin_hypertension	low-renin hypertension
3-hydroxy-4-pyrone	3-hydroxy-4-pyrone
allergic_hand_dermatitis	allergic hand dermatitis
2,3-dimercaptopropane-1-sulfonate	2,3-dimercaptopropane-1-sulfonate
1-hydroxy-anthraquinone	1-hydroxy-anthraquinone
oa	oa
prostate_cancer	prostate cancer
brain_lymphoma	brain lymphoma
11-keto-b-boswellic_acid	11-keto-b-boswellic acid
4-hydroxy-tamoxifen	4-hydroxy-tamoxifen
myocardial_damage	myocardial damage
17-ohcs	17-ohcs
marginal_biotin_deficiency	marginal biotin deficiency
11-methyl-17-ketone	11-methyl-17-ketone
3tc	3tc
parkinson	parkinson
gastroenteropancreatic_net	gastroenteropancreatic net
irritation	irritation
parturient_paresis	parturient paresis
3-aminobeanzamide	3-aminobeanzamide
axonal_charcot-marie-tooth	axonal charcot-marie-tooth
painful_bone_metastases	painful bone metastases
estrogen_receptor-positive_breast_cancer	estrogen receptor-positive breast cancer
2-oa	2-oa
experimental_rat_hepatocellular_carcinoma	experimental rat hepatocellular carcinoma
behavioral_impairments	behavioral impairments
2-aminopurine_deoxyribose_triphosphate	2-aminopurine deoxyribose triphosphate
cerebral_atrophy	cerebral atrophy
3,4-methylenedioxyethamphetamine	3,4-methylenedioxyethamphetamine
3,4-methylenedioxymeth-amphetamine	3,4-methylenedioxymeth-amphetamine
4-hipa	4-hipa
diabetic_vitreous_hemorrhage	diabetic vitreous hemorrhage
5-aminolevulinic_acid_hexyl_ester	5-aminolevulinic acid hexyl ester
increases_vascular_calcification	increases vascular calcification
lymphoplasmocytic_lymphoma	lymphoplasmocytic lymphoma
kb_carcinoma	kb carcinoma
sebaceous_gland_hyperplasia	sebaceous gland hyperplasia
123i-betamethyl-p-iodophenyl-pentadecanoic_acid	123i-betamethyl-p-iodophenyl-pentadecanoic acid
3-chloro-5-trifluoromethylpyridine-2-carboxylic_acid	3-chloro-5-trifluoromethylpyridine-2-carboxylic acid
17beta-estradiols	17beta-estradiols
14co2	14co2
hes	hes
malignant_gliomas	malignant gliomas
blood_coagulation	blood coagulation
hepatocellular_carcinoma	hepatocellular carcinoma
2-pyrrolidinone	2-pyrrolidinone
ad-like_lesions	ad-like lesions
17-octadecynoic_acid	17-octadecynoic acid
black_spot	black spot
leukaemia	leukaemia
cognitive_abnormalities	cognitive abnormalities
16a-18f-fluoroestradiol	16a-18f-fluoroestradiol
learning_and_memory_impairment	learning and memory impairment
2-furfural	2-furfural
186re-ethylene_dicysteine	186re-ethylene dicysteine
2,6-diaminopyridine	2,6-diaminopyridine
lateral_hypothalamus	lateral hypothalamus
testicular_tumour	testicular tumour
hypothyroid	hypothyroid
pn-related_liver_complications	pn-related liver complications
cartilage_impairment	cartilage impairment
3-acetyl-11-keto-beta-boswellic_acid	3-acetyl-11-keto-beta-boswellic acid
3-oaa	3-oaa
clinically_isolated_syndromes	clinically isolated syndromes
186re-hedp	186re-hedp
1-norepinephrine	1-norepinephrine
2-phenylpropenal	2-phenylpropenal
hemorrhage	hemorrhage
2-oxoglutarate	2-oxoglutarate
18-hydroxycortisol	18-hydroxycortisol
murine_insulinoma	murine insulinoma
fibrosarcoma	fibrosarcoma
pancreatic_acinar_cell_necrosis	pancreatic acinar cell necrosis
1r,2s-methoxamine	1r,2s-methoxamine
hyperreflexia	hyperreflexia
breast_cancer	breast cancer
pyoderma_gangrenosum	pyoderma gangrenosum
insoluble_aggregates	insoluble aggregates
ags	ags
3h-haloperidol	3h-haloperidol
hyperoxia	hyperoxia
lambert-eaton_syndrome	lambert-eaton syndrome
acute_intoxication	acute intoxication
4-hexylresorcinol	4-hexylresorcinol
primary_central_nervous_system_lymphoma	primary central nervous system lymphoma
pulmonary_injury	pulmonary injury
rccs	rccs
hematological_malignancies	hematological malignancies
1-nitropyrene	1-nitropyrene
5alpha-dihydrotestosterone	5alpha-dihydrotestosterone
oral_carcinogenesis	oral carcinogenesis
2-mercapto-2-methylpropanoyl-l-cysteine	2-mercapto-2-methylpropanoyl-l-cysteine
had	had
tbe	tbe
brain_disease	brain disease
3-mercaptopropionic_acid	3-mercaptopropionic acid
erdheim-chester_disease	erdheim-chester disease
ischemic	ischemic
diabetes_detection	diabetes detection
acyl-coa_hydrolase	acyl-coa hydrolase
tumor_aggressiveness	tumor aggressiveness
neurobehavioral_toxicity	neurobehavioral toxicity
verapamil_toxicity	verapamil toxicity
3-beta-hydroxysteroid	3-beta-hydroxysteroid
small_cell_lung_cancer	small cell lung cancer
186re_nr-lu-13	186re nr-lu-13
liver_fibrosis	liver fibrosis
cerebral_gliomas	cerebral gliomas
acute_promyelocytic	acute promyelocytic
2,6-diaminopurine	2,6-diaminopurine
13-cis-retinoic_acid	13-cis-retinoic acid
5-aminosalycilates	5-aminosalycilates
4-cmc	4-cmc
intestinal_injury	intestinal injury
typical_neonatal_hepatitis_syndrome	typical neonatal hepatitis syndrome
3-hydroxy-3-methylglutaril_coenzyme_a	3-hydroxy-3-methylglutaril coenzyme a
leprosy	leprosy
deficiency_and_insufficiency	deficiency and insufficiency
18f-fluoropaclitaxel	18f-fluoropaclitaxel
17-allylaminogeldanamycin	17-allylaminogeldanamycin
periodontal_diseases	periodontal diseases
2,4-dinitrothiocyanobenzene	2,4-dinitrothiocyanobenzene
forestomach_mucosa	forestomach mucosa
memory_deficit	memory deficit
5,6-benzoflavone	5,6-benzoflavone
bse	bse
central_diabetes_insipidus	central diabetes insipidus
4-mercaptoimidazole	4-mercaptoimidazole
18f-fibt	18f-fibt
5,6-dihydro-5-azacytidine	5,6-dihydro-5-azacytidine
neurological_illnesses	neurological illnesses
gal	gal
23-hydroxybetulinic_acid	23-hydroxybetulinic acid
3-hydroxymethyl-3-glutaryl_coenzyme_a	3-hydroxymethyl-3-glutaryl coenzyme a
energy_metabolic_disorder	energy metabolic disorder
cystic_acne	cystic acne
5,6_dht	5,6 dht
amyloidosis	amyloidosis
2-amino-6-arylsulfonylbenzonitriles	2-amino-6-arylsulfonylbenzonitriles
bc	bc
11-oxo-eicosatetranoic_acid	11-oxo-eicosatetranoic acid
myocardial_infarct	myocardial infarct
1alpha-hydroxycholecalciferol	1alpha-hydroxycholecalciferol
12-o-tetradecanoyl-13-phorbol_acetate	12-o-tetradecanoyl-13-phorbol acetate
blood_cancer	blood cancer
preterm_delivery	preterm delivery
18f-fludeoxyglucose	18f-fludeoxyglucose
3-oh-ga	3-oh-ga
3-ketoacyl-coa	3-ketoacyl-coa
13c-octanoic_acid	13c-octanoic acid
neointima	neointima
epithelial_carcinoma	epithelial carcinoma
deep_necrotic_lesions	deep necrotic lesions
32p	32p
demyelination	demyelination
nigrostriatal_degeneration	nigrostriatal degeneration
anaplastic_lymphoma	anaplastic lymphoma
18a-ga	18a-ga
12-o-tetradecanoylphorbol-13-acetate	12-o-tetradecanoylphorbol-13-acetate
1-nitroso-1-methyl_urea	1-nitroso-1-methyl urea
2-chlorophenol	2-chlorophenol
15-hpete	15-hpete
1-naphthylamine	1-naphthylamine
periodontitis	periodontitis
cutaneous_hsv-1_infection	cutaneous hsv-1 infection
3-hydroxybutyrate	3-hydroxybutyrate
hp	hp
3,4-bis-3,4,5-trimethoxybenzylidene-dihydrofuran	3,4-bis-3,4,5-trimethoxybenzylidene-dihydrofuran
1,2-dichlorohexafluorocyclobutane	1,2-dichlorohexafluorocyclobutane
neuropathic_pain	neuropathic pain
faster_transformation_activity	faster transformation activity
1,2-dimethyl-3-hydroxypyrid-4-one	1,2-dimethyl-3-hydroxypyrid-4-one
2mesadp	2mesadp
mastitis	mastitis
bladder_transitional_cell_carcinomas	bladder transitional cell carcinomas
allergy	allergy
cf	cf
3-acetylpyridine	3-acetylpyridine
juvenile_renal_osteodystrophy	juvenile renal osteodystrophy
lymphocytic_leukemia	lymphocytic leukemia
cognitive_dysfunction	cognitive dysfunction
end-stage_renal_disease	end-stage renal disease
3-substituted_triazinoindole	3-substituted triazinoindole
2,4_dncb	2,4 dncb
13,14-dihydro-15-keto_prostaglandin_f2_alpha	13,14-dihydro-15-keto prostaglandin f2 alpha
diabetic_retinas	diabetic retinas
lymphomas_of_t-lineage	lymphomas of t-lineage
blood_regurgitation	blood regurgitation
1,2-benzisothiazolin-3-one	1,2-benzisothiazolin-3-one
3-hydroxyglutaric_aciduria	3-hydroxyglutaric aciduria
2-heptylcyclopentanone	2-heptylcyclopentanone
2-3_diphosphoglycerate	2-3 diphosphoglycerate
2-pyridyl_cyclohexanone	2-pyridyl cyclohexanone
3-ab	3-ab
25-ohd3	25-ohd3
depressed	depressed
colorectal_cancers	colorectal cancers
ga	ga
1,1-dimethylbiguanide_hydrochloride	1,1-dimethylbiguanide hydrochloride
12-o-tetradecanylphorbol_13-acetate	12-o-tetradecanylphorbol 13-acetate
hepatitis_c_virus_infection	hepatitis c virus infection
rcdp	rcdp
contractures	contractures
traumatic_shock	traumatic shock
bowel_disease	bowel disease
spontaneous_skeletal_neoplasia	spontaneous skeletal neoplasia
perianal_lesions	perianal lesions
dyslipidemia	dyslipidemia
4-amino-2-tri-fluoromethyl-phenyl_ester	4-amino-2-tri-fluoromethyl-phenyl ester
mitochondrial_myopathy	mitochondrial myopathy
3,5,3_triiodothyroacetic_acid	3,5,3 triiodothyroacetic acid
2-phenyl-1,4-benzoquinone	2-phenyl-1,4-benzoquinone
overall_survival	overall survival
t-cell_acute_lymphoblastoid_leukemia	t-cell acute lymphoblastoid leukemia
3-iodocytisine	3-iodocytisine
hypoglycemic_coma	hypoglycemic coma
4-methylumbelliferone	4-methylumbelliferone
low_algal_toxicity	low algal toxicity
mi	mi
cin-2	cin-2
deficient_in_fetal_zone_cultures	deficient in fetal zone cultures
chondrosarcoma	chondrosarcoma
hypoxic_tumor	hypoxic tumor
subclinical_cardiovascular_disease	subclinical cardiovascular disease
postmenopausal_breast_cancer	postmenopausal breast cancer
hyperacusis	hyperacusis
fibromyalgia_syndrome	fibromyalgia syndrome
4-hydroxyandrostenedione	4-hydroxyandrostenedione
16,16-dimethyl_prostaglandin_e2	16,16-dimethyl prostaglandin e2
muscle_paralysis	muscle paralysis
infection_and_inflammation	infection and inflammation
2-ohe1	2-ohe1
endotoxic_shock	endotoxic shock
sap	sap
3-pg	3-pg
hypoplastic_anemia	hypoplastic anemia
1a,25-hydroxycholecalciferol	1a,25-hydroxycholecalciferol
rcm	rcm
4-nitroquinoline-n-oxide	4-nitroquinoline-n-oxide
hypophosphataemic_osteomalacia	hypophosphataemic osteomalacia
erythroleukemia	erythroleukemia
carcinomas_of_the_colon_and_pancreas	carcinomas of the colon and pancreas
hepatitis	hepatitis
1,25-dihydroxyvitamin-d3	1,25-dihydroxyvitamin-d3
stomach_tumors	stomach tumors
delirium	delirium
bronchiolitis	bronchiolitis
4-chloro-e2	4-chloro-e2
4-ohcp	4-ohcp
3,5-dihydroxyphenylglycine	3,5-dihydroxyphenylglycine
metd	metd
inhibited_ear_edema	inhibited ear edema
4-hydroxyamesergide	4-hydroxyamesergide
dyskinetic	dyskinetic
17-hydroxy_steroid	17-hydroxy steroid
1-fluoro-2,4-dinitrobenzene	1-fluoro-2,4-dinitrobenzene
se	se
basophilic_leukemia	basophilic leukemia
3-methoxy-phencyclidine	3-methoxy-phencyclidine
nephrosis	nephrosis
13_cis-retinoic_acid	13 cis-retinoic acid
1-tetradecene	1-tetradecene
idiopathic_pulmonary_arterial_hypertension	idiopathic pulmonary arterial hypertension
nodal_metastasis	nodal metastasis
liver_toxicity	liver toxicity
increase_in_the_number_of_osteoclastlike_cells	increase in the number of osteoclastlike cells
123i-orthoiodohippurate	123i-orthoiodohippurate
low_toxicity	low toxicity
heat_shock	heat shock
gastroenteropancreatic_neuroendocrine_tumors	gastroenteropancreatic neuroendocrine tumors
1-14c_linoleic_acid	1-14c linoleic acid
123i-metaiodobenzylguanidine	123i-metaiodobenzylguanidine
leukaemias	leukaemias
1-ethyl-3-methylimidazolium_hexafluorophosphate	1-ethyl-3-methylimidazolium hexafluorophosphate
myocardial_hypoxia	myocardial hypoxia
pha	pha
4-1bb-fc	4-1bb-fc
gestational_trophoblastic_tumours	gestational trophoblastic tumours
pemphigus_vulgaris	pemphigus vulgaris
pdgf	pdgf
1,4-butanediol_dimethylsulfonyl_ester	1,4-butanediol dimethylsulfonyl ester
1-methyl-4-phenyl-1,2,3,6-tetrahidropyridine	1-methyl-4-phenyl-1,2,3,6-tetrahidropyridine
beta-galactosidase	beta-galactosidase
chronic_cerebral_hypoperfusion	chronic cerebral hypoperfusion
2,3-dinorthromboxane_b2	2,3-dinorthromboxane b2
18f-fluoroethyl-l-tyrosine	18f-fluoroethyl-l-tyrosine
stage_i_neuroblastoma	stage i neuroblastoma
1,3-benzodioxoles	1,3-benzodioxoles
cord_ependymomas	cord ependymomas
4-methylbenzoic_acid	4-methylbenzoic acid
hypercholesterolemic_plasma	hypercholesterolemic plasma
pituitaries	pituitaries
3,4,5-tri-o-caffeoylquinic_acid	3,4,5-tri-o-caffeoylquinic acid
3h_thymidine	3h thymidine
adrenal_adenoma	adrenal adenoma
salmonella	salmonella
weakness	weakness
hemorrhagic_rectocolitis	hemorrhagic rectocolitis
mantle-cell_lymphoma	mantle-cell lymphoma
14c-progesterone	14c-progesterone
5-aminosalicylic	5-aminosalicylic
4-n-hydroxy-l-2,4-diaminobutyric_acid	4-n-hydroxy-l-2,4-diaminobutyric acid
glioma_tumour	glioma tumour
ils	ils
lps	lps
17dmag	17dmag
hyporesponsiveness	hyporesponsiveness
growth_retardation	growth retardation
atom_bombardment-ms	atom bombardment-ms
tg	tg
hp_infection	hp infection
impairment_of_movement	impairment of movement
acute_pancreatitis	acute pancreatitis
neurological_impairment	neurological impairment
tongue_neoplasms	tongue neoplasms
4-o-methyl-pma	4-o-methyl-pma
renal_injury	renal injury
colon_carcinogenesis	colon carcinogenesis
coronary_atherosclerotic_plaque	coronary atherosclerotic plaque
18f-bpa	18f-bpa
anterior_middle_neck_tumor	anterior middle neck tumor
cardiac_and_skeletal_muscle	cardiac and skeletal muscle
angina	angina
4-aminosalicylic_acid	4-aminosalicylic acid
4-hydroxy-ifo	4-hydroxy-ifo
primary_hyperparathyroidism	primary hyperparathyroidism
2me	2me
memory_deficits	memory deficits
pseudomonas_aeruginosa_infection	pseudomonas aeruginosa infection
cardiac_lesions	cardiac lesions
1843u89	1843u89
focal_epilepsies	focal epilepsies
4-alpha-phorbol_12,13-didecanoate	4-alpha-phorbol 12,13-didecanoate
fibromyalgia	fibromyalgia
4-hydroxypyrazole	4-hydroxypyrazole
18fdg	18fdg
2-hydrazino-4,6-dimethylpyrimidine	2-hydrazino-4,6-dimethylpyrimidine
acute_disease	acute disease
brain_death	brain death
muscular_diseases	muscular diseases
evolution_of_skeletal_hyperostoses	evolution of skeletal hyperostoses
premature_mitosis	premature mitosis
breast_cancer_lesions	breast cancer lesions
3-o-sulfotransferases	3-o-sulfotransferases
uia	uia
sleep_disorders	sleep disorders
ed	ed
prostatic_neoplasms	prostatic neoplasms
1,4-gl	1,4-gl
fry_malformation	fry malformation
3alpha-dihydrocadambine	3alpha-dihydrocadambine
colorectal_dysplasias	colorectal dysplasias
17-b-estradiol	17-b-estradiol
lymphoid_neoplasms	lymphoid neoplasms
4-pregnen-20-alpha-one	4-pregnen-20-alpha-one
5-aminolaevulinic_acid	5-aminolaevulinic acid
hyperpyrexia	hyperpyrexia
188re-rc-160	188re-rc-160
mb	mb
2-hydroxylglutarate	2-hydroxylglutarate
prolymphocytic_leukemia	prolymphocytic leukemia
2-brom-alpha-ergocryptine	2-brom-alpha-ergocryptine
pdd	pdd
mckrae_strain_herpes_simplex_virus	mckrae strain herpes simplex virus
ocular_toxicity	ocular toxicity
erythrocytosis	erythrocytosis
11-deoxyprostaglandin_e1	11-deoxyprostaglandin e1
chest_pain	chest pain
4-trifluoromethyl-7-hydroxy-3,3-dimethylindolinyl_analogue_4	4-trifluoromethyl-7-hydroxy-3,3-dimethylindolinyl analogue 4
16-alpha-123i-iodoestradiol-17-beta	16-alpha-123i-iodoestradiol-17-beta
2,4,6-trinitrobenzenesulphonic_acid_sodium_salt	2,4,6-trinitrobenzenesulphonic acid sodium salt
azoospermia	azoospermia
promyelocytic_leukaemia	promyelocytic leukaemia
forestomach_tumours	forestomach tumours
essential_and_renovascular_hypertension	essential and renovascular hypertension
gdhd	gdhd
18f_fdg	18f fdg
colorectal_adenomas	colorectal adenomas
14-deoxy-11,12-didehydroandrographolide	14-deoxy-11,12-didehydroandrographolide
4-hydroxy-17alpha-methyltestosterone	4-hydroxy-17alpha-methyltestosterone
2-thiazolylethylamine	2-thiazolylethylamine
hematologic_and_skeletal_abnormalities	hematologic and skeletal abnormalities
17-cooh-7da	17-cooh-7da
hippocampal-entorhinal_cortex_slices	hippocampal-entorhinal cortex slices
14c-urea	14c-urea
3f-pcc	3f-pcc
2,7-dichlorofluorescein_diacetate	2,7-dichlorofluorescein diacetate
lewy_body_disease	lewy body disease
epithelial_tumours	epithelial tumours
13c-urea	13c-urea
ccc	ccc
rheumatic_disease	rheumatic disease
2-methylthio-adp	2-methylthio-adp
3-deazaguanine	3-deazaguanine
nerve_injury	nerve injury
5,5-dimethyl-1-pyrroline_n-oxide	5,5-dimethyl-1-pyrroline n-oxide
l1210_leukemia	l1210 leukemia
non-hispanic_whites	non-hispanic whites
1,2-dimethylhydrasine	1,2-dimethylhydrasine
b16_melanoma	b16 melanoma
ap	ap
pulmonary_sarcoidosis	pulmonary sarcoidosis
gastric_malt_lymphoma	gastric malt lymphoma
electroshock_seizures	electroshock seizures
cah	cah
3-b-3	3-b-3
pituitary_tumors	pituitary tumors
3h-vincristine	3h-vincristine
2-de	2-de
2-iminobiotin	2-iminobiotin
140-kd	140-kd
nerve_damage	nerve damage
urothelial_lesions	urothelial lesions
2-deoxy_d-glucose	2-deoxy d-glucose
vascular_ring	vascular ring
pheochromocytoma	pheochromocytoma
purine_derivatives	purine derivatives
2-phenylethanol	2-phenylethanol
1-hchpk	1-hchpk
1-d-myo-inositol-3-phosphate	1-d-myo-inositol-3-phosphate
4-aminobiphenyl	4-aminobiphenyl
malignant_intraductal_papillary_mucinous_neoplasms	malignant intraductal papillary mucinous neoplasms
spinal_cord_injury	spinal cord injury
2-aap	2-aap
4-cholesten-3-one	4-cholesten-3-one
endoplasmic_reticulum_stress	endoplasmic reticulum stress
forestomach_neoplasms	forestomach neoplasms
4-hydroxycoumarin	4-hydroxycoumarin
sad	sad
4-aminoquinoline	4-aminoquinoline
adrenal_cryptococcosis	adrenal cryptococcosis
drug_for_lung_cancer	drug for lung cancer
1-methyl-4phenyl-1,2,3,6-tetrahydropyridine	1-methyl-4phenyl-1,2,3,6-tetrahydropyridine
3,4-dideoxyglucosone-3-ene	3,4-dideoxyglucosone-3-ene
gliomas	gliomas
atherosclerotic_plaques	atherosclerotic plaques
11oha4	11oha4
mcrpc	mcrpc
2-sulphanilamido-5-methoxypyrimidine	2-sulphanilamido-5-methoxypyrimidine
18-fluoro-2-deoxy-d-glucose	18-fluoro-2-deoxy-d-glucose
2-hydroxypropyl-b-cyclodextrin	2-hydroxypropyl-b-cyclodextrin
