diffuse alopecia	diffuse_alopecia
amoebiasis due to entamoeba histolytica	Entamoeba_gingivalis
severe combined immunodeficiency due to adenosine deaminase deficiency	deficiency_of_adenosine_deaminase
painful ophthalmoplegia	painful_ophthalmoplegia
primary angiitis of the central nervous system	primary_angiitis_of_the_central_nervous_system
ramon syndrome	Ramon_syndrome
rapadilino syndrome	RAPADILINO_syndrome
rapp-hodgkin syndrome	Rapp-Hodgkin_syndrome
ray peterson scott syndrome	lumbar_Smith-Peterson_osteotomies
recurrent respiratory papillomatosis	Recurrent_respiratory_papillomatosis
type 4e charcot-marie-tooth disease	CHN-associated_urothelial_malignancy
3-methylcrotonyl coa carboxylase 1 deficiency	beta-methylcrotonyl-CoA_carboxylase_deficiency
costeff optic atrophy syndrome	Costeff_Syndrome
xyy syndrome 47	XYY_syndrome
5-oxoprolinase deficiency	5-Oxoprolinase_deficiency
6-pyruvoyl-tetrahydropterin synthase deficiency	PTPS_deficiency
holt-oram syndrome	Holt-Oram_Syndrome
holzgreve wagner rehder syndrome	senanensis_Rehder_extract
homocarnosinosis	homocarnosinosis
abcd syndrome	ABCD_syndrome
alopecia cataract	Sclerodactyly
zonular cataract	congenital_lamellar_cataract
catel manzke syndrome	Catel-Manzke_syndrome
cayler cardiofacial syndrome	cardiofacial_syndrome
capos syndrome	CAPOS_syndrome
choroidal sclerosis	choroidal_sclerosis
dermatopathia pigmentosa reticularis	dermatopathia_pigmentosa_reticularis
arthrogryposis renal dysfunction cholestasis syndrome	ARC_syndrome
progressive pseudorheumatoid arthropathy	progressive_pseudorheumatoid_dysplasia
arts syndrome	Arts_syndrome
ataxia with vitamin e deficiency	ataxia_with_vitamin_E_deficiency
atelosteogenesis type 2	atelosteogenesis_type_II
type 1 atelosteogenesis	atelosteogenesis_type_I
athabaskan brainstem dysgenesis	Brainstem_dysgenesis
gamma aminobutyric acid transaminase deficiency	gamma-aminobutyrate_aminotransferase
gamma-cystathionase deficiency	cystathionase
type 4a charcot-marie-tooth disease	Charcot-Marie-Tooth_disease_type_4A
type 4b1 charcot-marie-tooth disease	Charcot-Marie-Tooth_type_4B
type 4b2 charcot-marie-tooth disease	ENaC_endocytosis
type 4c charcot-marie-tooth disease	Charcot-Marie-Tooth_disease_type_4C
bethlem myopathy	Bethlem_myopathy
bietti crystalline dystrophy	Bietti_crystalline_dystrophy
bifid nose	bifid_epiglottis
chylomicron retention disease	Chylomicron_retention_disease
convulsions benign familial neonatal dominant form	Benign_familial_neonatal_seizures
familial benign copper deficiency	Male_copper_deficient
corneal dystrophy and perceptive deafness	perceptive_deafness
corneal dystrophy avellino type	granular_corneal_dystrophy_type_2
crystalline corneal dystrophy	Schnyder_crystalline_corneal_dystrophy
type 1 corneal dystrophy of bowman layer	Reis-Buckler_corneal_dystrophy
gelatinous drop-like corneal dystrophy	gelatinous_droplike_corneal_dystrophy
freeman-sheldon syndrome	Freeman_Sheldon_syndrome
ring chromosome 14 syndrome	ring_chromosome_14
lethal acantholytic epidermolysis bullosa	lethal_acantholytic_epidermolysis_bullosa
multiple epiphyseal dysplasia	recessive_multiple_epiphyseal_dysplasia
myh9-related disorders	MYH9_disorders
ermine phenotype	auditory-pigmentary_syndrome
erythema elevatum diutinum	erythema_elevatum_diutinum
receptor 1 interferon gamma	chitosan_interferon-gamma_nanogene
isobutyryl-coa dehydrogenase deficiency	Isobutyryl-CoA_dehydrogenase_deficiency
abidi x-linked mental retardation syndrome	depolarization_slope
ablepharon macrostomia syndrome	Ablepharon_macrostomia_syndrome
absent patella	Patella
cantu syndrome	Cantu_syndrome
cardiofaciocutaneous syndrome	Cardiofaciocutaneous_syndrome
infantile histiocytoid cardiomyopathy	oncocytic_cardiomyopathy
carnitine palmitoyl transferase 2 deficiency	carnitine_palmitoyl_transferase_2_deficiency
dopamine beta hydroxylase deficiency	dopamine-beta-hydroxylase_deficiency
aicardi-goutieres syndrome	Aicardi-Goutieres_syndrome
hantavirosis	HTVF_infection
harlequin syndrome	Harlequin_syndrome
gastrocutaneous syndrome	Gastrocutaneous_fistula
acrokeratoelastoidosis of costa	Acrokeratoelastoidosis
acromegaloid facial appearance syndrome	Cushingoid_appearance
acromelic frontonasal dysplasia	acromelic_dysplasia
acromesomelic dysplasia	acromesomelic_dysplasia
maroteaux type acromesomelic dysplasia	ST-T_abnormalities
acromicric dysplasia	acromicric_dysplasia
richieri costa pereira syndrome	Richieri-Costa-Pereira_syndrome
axenfeld-rieger syndrome	axenfeld-rieger_syndrome
rigid spine syndrome	rigid_spine_muscular_dystrophy
roberts syndrome	Roberts_Syndrome
robin sequence and oligodactyly	oligodactyly
malonic aciduria	Malonic_aciduria
mandibuloacral dysplasia with type a lipodystrophy	mandibuloacral_dysplasia_type_A_osteoblasts
mandibuloacral dysplasia with type b lipodystrophy	mandibuloacral_dysplasia
hereditary motor and sensory neuropathy	Charcot-Marie-Tooth_disease_type_4D
dubowitz syndrome	Dubowitz-like_syndrome
familial duodenal atresia	duodenal_atresia
dwarfism tall vertebrae	tall_stereocilia_rows
dyggve-melchior-clausen syndrome	Dyggve-Melchior-Clausen_syndrome
dyschromatosis symmetrica hereditaria 1	Dyschromatosis_symmetrica_hereditaria
dysequilibrium syndrome	dysequilibrium_syndrome
emanuel syndrome	monohydroxy_derivative
congenital lobar emphysema	lobar_emphysema
encephalocraniocutaneous lipomatosis	encephalocraniocutaneous_lipomatosis
erythrokeratodermia with ataxia	Erythrokeratodermia
congenital heart block	congenital_heart_block
congenital nephrosis	congenital_nephrosis
metatarsal type czech dysplasia	Czech_dysplasia
autosomal recessive spondylocostal dysostosis	autosomal_recessive_spondylocostal_dysostosis
spondyloenchondrodysplasia	spondyloenchondrodysplasia
congenita spondyloepiphyseal dysplasia	hereditary_spondyloepiphyseal_dysplasia_congenita
omani type spondyloepiphyseal dysplasia	Omani-type_spondyloepiphyseal_dysplasia
axial spondylometaphyseal dysplasia	Axial_Spondylometaphyseal_Dysplasia
sedaghatian type spondylometaphyseal dysplasia	Sedaghatian-type_spondylometaphyseal_dysplasia
mohr-tranebjaerg syndrome	Mohr-Tranebjaerg_Syndrome
pruritic urticarial papules plaques of pregnancy	urticarial-like_plaques
pseudo-zellweger syndrome	pseudo-Zellweger_syndrome
pseudoachondroplasia	Pseudoachondroplasia
pseudodiastrophic dysplasia	pseudodiastrophic_dysplasia
heart defects limb shortening	telomere_shortening
familial pulmonary capillary hemangiomatosis	pulmonary_capillary_hemangiomatosis
autosomal recessive robinow syndrome	Autosomal_recessive_Robinow_syndrome
johanson blizzard syndrome	Johanson-Blizzard_syndrome
leukocyte adhesion deficiency type 1	Leukocyte_adhesion_deficiency_type_1
leukonychia totalis	Leukonychia
marie unna congenital hypotrichosis	Marie_Unna_hereditary_hypotrichosis
cartilage-hair hypoplasia	Cartilage_hair_hypoplasia
schmid-fraccaro syndrome	Cat_eye_syndrome
x-linked charcot-marie-tooth disease	X-linked_Charcot-Marie_Tooth_disease
cheilitis glandularis	Cheilitis_glandularis
chilblain lupus 1	Chilblain_lupus
intrahepatic cholestasis of pregnancy	intrahepatic_cholestasis_of_pregnancy
progressive familial intrahepatic 1 cholestasis	progressive_familial_intrahepatic_cholestasis
progressive familial intrahepatic 2 cholestasis	progressive_familial_intrahepatic_cholestasis_type_2
thiel-behnke type corneal dystrophy	Thiel-Behnke_corneal_dystrophy
desbuquois syndrome	Desbuquois_dysplasia
eosinophilic enteropathy	eosinophilic_gastroenteropathy
epidermolysis bullosa simplex with mottled pigmentation	Epidermolysis_bullosa_simplex_with_mottled_pigmentation
ogna type epidermolysis bullosa simplex	epidermolysis_bullosa_simplex_Ogna
cole carpenter syndrome	Cole-Carpenter_Syndrome
congenital adrenal hyperplasia due to 11-beta-hydroxylase deficiency	congenital_adrenal_hyperplasia_due_to_II_beta-hydroxylase_deficiency
congenital amegakaryocytic thrombocytopenia	congenital_amegakaryocytic_thrombocytopenia
congenital bilateral aplasia of vas deferens	Congenital_bilateral_absence_of_vas_deferens
de barsy syndrome	Magellanic_cloud_planetary_nebula
de sanctis-cacchione syndrome	De_Sanctis-Cacchione_Syndrome
familial apoceruloplasmin deficiency	ceruloplasmin_deficiency
achalasia addisonianism alacrimia syndrome	achalasia-addisonianism-alacrima_syndrome
acheiropodia	Acheiropodia
achondrogenesis type 1b	rhinovirus_type_1B
achondrogenesis type 2	chondrogenesis_retardation
marshall syndrome	Marshall_syndrome
marshall-smith syndrome	Marshall-Smith_syndrome
aphasia masa (mental retardation	phytoplankton_crash
mass syndrome	Overlap_syndrome
medium chain acyl coa dehydrogenase deficiency	Medium-Chain_Acyl-CoA_dehydrogenase_deficiency
type 3 osteogenesis imperfecta	type_III_osteogenesis_imperfecta
osteoglophonic dwarfism	osteoglophonic_dysplasia
osteolysis hereditary multicentric	nodulosis-arthropathy-osteolysis_syndrome
osteopathia striata cranial sclerosis	Osteopathia_striata_with_cranial_sclerosis
osteopetrosis autosomal dominant type 1	Autosomal_Dominant_Osteopetrosis_type_I
osteopetrosis with renal tubular acidosis	autosomal_recessive_syndrome_of_osteopetrosis_with_renal_tubular_acidosis
osteoporosis-pseudoglioma syndrome	Osteoporosis-pseudoglioma_syndrome
hoyeraal hreidarsson syndrome	Hoyeraal-Hreidarsson_Syndrome
hydrolethalus syndrome	Hydrolethalus_syndrome
ichthyosis follicularis atrichia photophobia syndrome	IFAP_syndrome
myoclonic dystonia	myoclonic_dystonia
myopathy with lactic acidosis and sideroblastic anemia	lactic_acidosis_and_sideroblastic_anemia
n syndrome	N_syndrome
nevo syndrome	Nevo_syndrome
congenital stationary night blindness	congenital_stationary_night_blindness
mediastinal fibrosis	Fibrosing_mediastinitis
palmoplantar keratoderma with deafness	inherited_palmoplantar_keratoderma
keratolytic winter erythema	keratolytic_winter_erythema
x-linked keratosis follicularis spinulosa decalvans	keratosis_follicularis_spinulosa_decalvans
keutel syndrome	Keutel_syndrome
dicarboxylicaminoaciduria	dicarboxylic_aminoaciduria
diffuse panbronchiolitis	diffuse_panbronchiolitis
ectodermal dysplasia-skin fragility syndrome	ectodermal_dysplasia-skin_fragility_syndrome
familial ectopia lentis	isolated_ectopia_lentis
progeroid form ehlers-danlos syndrome	neurosteroid_biosynthesis
elastosis perforans serpiginosa	Elastosis_perforans_serpiginosa
elejalde disease	psycho-neuro-autonomic_disorders
congenital central hypoventilation syndrome	congenital_central_hypoventilation_syndrome
congenital chloride diarrhea	Congenital_chloride_diarrhea
congenital contractural arachnodactyly	Congenital_contractural_arachnodactyly
type 2 crigler najjar syndrome	type_II_Crigler-Najjar_syndrome
crisponi syndrome	Crisponi_syndrome
currarino triad	Currarino_syndrome
cushing's symphalangism	Proximal_symphalangism
cutis marmorata telangiectatica congenita	Cutis_Marmorata_Telangiectatica_Congenita
cyclic neutropenia	cyclic_neutropenia
cyprus facial neuromusculoskeletal syndrome	self-reported_neuromusculoskeletal_problems
familial dilated cardiomyopathy	Familial_dilated_cardiomyopathy
blount disease	Blount_Disease
blue cone monochromatism	mono-ion_complex
blue diaper syndrome	blue_diaper_syndrome
blue rubber bleb nevus syndrome	Blue_Rubber_Bleb_Nevus_Syndrome
noninsulin-dependent diabetes mellitus with deafness	maternally_inherited_diabetes_and_deafness
pyle disease	metaphyseal_sclerosis
pyridoxine-dependent epilepsy	Pyridoxine_dependent_epilepsy
pyruvate dehydrogenase phosphatase deficiency	dehydrogenase_phosphatase_deficiency
quebec platelet disorder	Quebec_platelet_disorder
radio renal syndrome	radio-immunotherapy
ichthyosis prematurity syndrome	ichthyosis_prematurity_syndrome
idiopathic pulmonary hemosiderosis	idiopathic_pulmonary_hemosiderosis
iminoglycinuria	iminoglycinuria
male sterility due to y-chromosome deletions	Y_chromosome_deletions
patterned dystrophy of retinal pigment epithelium	retinal_pigment_epithelium
peho syndrome	PEHO_syndrome
poikiloderma of kindler	kindler_syndrome
polycystic lipomembranous osteodysplasia with sclerosing leukoencephalopathy	polycystic_lipomembranous_osteodysplasia
polycystic liver disease	polycystic_liver_disease
hereditary expansile polyostotic osteolytic dysplasia	familial_expansile_osteolysis
posterior column ataxia with retinitis pigmentosa	posterior_column_ataxia_and_retinitis_pigmentosa
vitreoretinochoroidopathy	vitreoretinochoroidopathy
hereditary spherocytic hemolytic anemia	phytoplankton_debris
angiostrongyliasis	angiostrongyliasis
anonychia onychodystrophy	dystrophic_nails
exudative vitreoretinopathy 1	autosomal_dominant_exudative_vitreoretinopathy
faces syndrome	face_paint
donnai-barrow syndrome	Donnai-Barrow_syndrome
neonatal hemochromatosis	idiopathic_hemochromatosis
neu laxova syndrome	Neu-Laxova_syndrome
neural crest tumor	neural_crest_tumor
neuraminidase deficiency with beta-galactosidase deficiency	Beta-galactosidase-neuraminidase_deficiency
primary hyperoxaluria type 1	primary_hyperoxaluria_type_1
primary orthostatic tremor	primary_orthostatic_tremor
neonatal progeroid syndrome	atypical_progeroid_syndrome
codas syndrome	CODAS_syndrome
coffin-siris syndrome	Coffin-Siris_Syndrome
cohen syndrome	Cohen_Syndrome
corneodermatoosseous syndrome	corneal_epithelial_wound_repair
costocoracoid ligament congenitally short	cranial_cruciate_ligament_deficiency
craniofacial deafness hand syndrome	craniofacial-deafness-hand_syndrome
craniofacial dyssynostosis	craniosynostosis_and_facial_dysostosis
craniofrontonasal dysplasia	craniofrontonasal_syndrome
waardenburg syndrome type 2	Waardenburg_syndrome_type_2
paternal uniparental disomy	Paternal_uniparental_disomy
urofacial syndrome	urofacial_syndrome
hereditary renal agenesis	display_renal_agenesis
uveal melanoma	Uveal_melanoma
vacterl association	VACTERL_syndrome
thanatophoric dysplasia glasgow variant	Apache_II_and_Glasgow_scores
thiamine responsive megaloblastic anemia syndrome	Thiamine_responsive_megaloblastic_anemia_syndrome
thomas syndrome	Thomas_II_cardioplegia
thoracolaryngopelvic dysplasia	Barnes_Akathisia
valproic acid antenatal infection	Fetal_valproate_syndrome
van der woude syndrome	Van_Der_Woude_syndrome
vater association	Vater_papilla
vein of galen aneurysm	vein_of_Galen_aneurysm
tricho-dento-osseous syndrome	Tricho-Dento-Osseous_syndrome
trichodental syndrome	MOTA_syndrome
trichofolliculoma	trichofolliculoma
chanarin-dorfman syndrome	Chanarin-Dorfman_Syndrome
triphalangeal thumbs brachyectrodactyly	triphalangeal_thumb-brachyectrodactyly_syndrome
boomerang dysplasia	boomerang_dysplasia
borjeson-forssman-lehmann syndrome	Borjeson-Forssman-Lehmann_syndrome
alpha-ketoglutarate dehydrogenase deficiency	alpha-ketoglutarate_deficiency
dominant type alport syndrome	Autosomal_dominant_Alport_syndrome
recessive type alport syndrome	autosomal_recessive_Alport_syndrome
alternating hemiplegia of childhood	Alternating_Hemiplegia_of_Childhood
alveolar echinococcosis	Alveolar_Echinococcosis
ambras syndrome	Ambras_syndrome
amelogenesis imperfecta hypomaturation type	hypomaturation_amelogenesis_imperfecta
brody myopathy	Brody_myopathy
familial cylindromatosis	familial_cylindromatosis
satoyoshi syndrome	Satoyoshi_syndrome
scalp ear nipple syndrome	scalp-ear-nipple_syndrome
schimke immunoosseous dysplasia	Schimke_immunoosseous_dysplasia
schneckenbecken dysplasia	Schneckenbecken_dysplasia
schwannomatosis	schwannomatosis
pendred syndrome	Pendred_Syndrome
penis agenesis	micropenis
pentosuria	Pentosuria
phosphoenolpyruvate carboxykinase deficiency	phosphoenolpyruvate_carboxykinase_deficiency
persistent mullerian duct syndrome	Persistent_Mullerian_Duct_Syndrome
snowflake vitreoretinal degeneration	snowflake_vitreoretinal_degeneration
weaver syndrome	Weaver_syndrome
wells syndrome	Wells_syndrome
weyers acrofacial dysostosis	Weyers_acrofacial_dysostosis
whim syndrome	WHIM_Syndrome
winship viljoen leary syndrome	severe_syndrome
young mckeever squier syndrome	pontocerebellar_hypoplasia_type_4
young syndrome	Young_syndrome
zlotogora-ogur syndrome	ectodermal_dysplasia_clefting_syndrome
wolcott-rallison syndrome	Wolcott-Rallison_syndrome
woodhouse sakati syndrome	Woodhouse-Sakati_Syndrome
congenital woolly hair	Congenital_woolly_hair
worster drought syndrome	Worster-Drought_syndrome
wrinkly skin syndrome	allelic_to_wrinkly_skin_syndrome
wt limb blood syndrome	WT_myotubes
x-linked sideroblastic anemia	X-linked_Sideroblastic_Anemia
variant type xeroderma pigmentosum	xeroderma_pigmentosum_variant
yemenite deaf-blind hypopigmentation syndrome	Yemenite_deaf-blind_syndrome
spastic ataxia charlevoix-saguenay type	autosomal_recessive_spastic_ataxia_of_Charlevoix-Saguenay
craniosynostosis radial aplasia syndrome	radial_aplasia_and_craniosynostosis
chromosome 22 ring	ring_chromosome_22
nonaka type distal myopathy	Hereditary_inclusion_body_myopathy
glomus vagale tumors	glomus_vagale_tumor
glutaric acidemia i	Glutaric_acidemia_type_I
glutathione synthetase deficiency	glutathione_synthetase_deficiency
aplasia cutis congenita of limbs recessive	syndromic_cutis_aplasia_and_limb_anomalies
familial encephalopathy with neuroserpin inclusion bodies	familial_encephalopathy_with_neuroserpin_inclusion_bodies
x-linked spastic paraplegia 2	X-linked_spastic_paraplegia
king denborough syndrome	King-Denborough_syndrome
familial thrombomodulin anomalies	thrombomodulin-deficient
acquired thrombotic thrombocytopenic purpura	idiopathic_thrombotic_thrombocytopenic_purpura
thymic epithelial tumor	Thymic_epithelial_tumors
familial medullary thyroid carcinoma	Familial_MTC
medullary thyroid cancer	medullary_thyroid_cancer
tufted angioma	Tufted_Angioma
ulnar hypoplasia lobster claw deformity of feet	hepatopancreas_of_the_lobster
ulnar-mammary syndrome	ulnar-mammary_syndrome
tarp syndrome	TARP_syndrome
tel hashomer camptodactyly syndrome	Hashomer_camptodactyly_syndrome
familial temporal epilepsy	familial_temporal_lobe_epilepsy
familial testotoxicosis	testotoxicosis
timothy syndrome	Timothy_Syndrome
townes-brocks syndrome	Townes-Brocks_Syndrome
tracheal agenesis	tracheal_agenesis
transient bullous dermolysis of the newborn	Transient_bullous_dermolysis_of_the_newborn
transient erythroblastopenia of childhood	congenital_erythroblastopenia
mosaic variegated aneuploidy syndrome	Mosaic_variegated_aneuploidy_syndrome
mowat-wilson syndrome	Mowat-Wilson_Syndrome
kaposiform hemangioendothelioma	Kaposiform_hemangioendothelioma
kaufman oculocerebrofacial syndrome	Kaufman_oculocerebrofacial_syndrome
kbg syndrome	KBG_syndrome
type 2 kenny-caffey syndrome	Kenny-Caffey_syndrome
hereditary keratitis	superficial_keratitis_lesions
lipoid congenital adrenal hyperplasia	Lipoid_Congenital_Adrenal_Hyperplasia
lowry wood syndrome	Lowry_Wood_syndrome
albinism deafness syndrome	albinism-deafness_syndrome
allan-herndon-dudley syndrome	Allan-Herndon-Dudley-syndrome
alopecia universalis	Alopecia_Universalis
floating-harbor syndrome	floating-harbor_syndrome
foix chavany marie syndrome	automatic_coagulometer
isolated follicle-stimulating hormone deficiency	Follicle-stimulating_hormone
bowen-conradi syndrome	Bowen-Conradi_syndrome
brachydactyly type a1	Brachydactyly_type_A1
brachydactyly type a2	brachydactyly_type_A2
brachydactyly type c	brachydactyly_type_C
brachyolmia	brachyolmia
brown-vialetto-van laere syndrome	Brown-Vialetto-van_Laere_syndrome
lenz majewski hyperostotic dwarfism	hyperostotic
leri-weil syndrome	Leri-Weill_Syndrome
opsismodysplasia	opsismodysplasia
oroticaciduria 1	oroticaciduria
familial hypocalciuric hypercalcemia	Familial_hypocalciuric_hypercalcemia
type 3 familial benign hypercalcemia	familial_hypocalciuric_hypercalcemia_type_3
hypoparathyroidism familial isolated	Isolated_Hypoparathyroidism
hypotrichosis simplex	hereditary_hypotrichosis_simplex
pancreatoblastoma	pancreatoblastoma
paroxysmal nonkinesigenic dyskinesia	paroxysmal_dystonic_spells
pierson syndrome	Pierson_syndrome
rufous oculocutaneous albinism	Brown_OCA
spinocerebellar ataxia 13	SCA_type_13
spinocerebellar ataxia 14	neurodegenerative_disease_spinocerebellar_ataxia_type_14
spinocerebellar ataxia 28	spinocerebellar_ataxia_type_28
spinocerebellar ataxia 29	Cerebellar_vermis_aplasia
kniest dysplasia	Kniest_dysplasia
knobloch syndrome	Knobloch_syndrome
saccharopinuria	saccharopinuria
sarcosinemia	sarcosinemia
x-linked properdin deficiency	P-glycoprotein_deficiency
familial prostate cancer	hereditary_prostate_cancer
type 2 hemochromatosis	Juvenile_hemochromatosis
type 3 hemochromatosis	Type_3_hemochromatosis
langer mesomelic dysplasia	Langer_mesomelic_dysplasia
fountain syndrome	fullness
goldberg-shprintzen megacolon syndrome	Goldberg-Shprintzen_syndrome
gordon syndrome	Gordon_syndrome
greig cephalopolysyndactyly syndrome	Greig_cephalopolysyndactyly_syndrome
griscelli syndrome type 1	Griscelli_syndrome
griscelli syndrome type 2	Griscelli_syndrome_type_2
x-linked spinocerebellar ataxia	PD-linked_product
short syndrome	short_femoropopliteal_lesions
shprintzen golberg craniosynostosis	marfanoid_syndrome
siderius x-linked mental retardation syndrome	Siderius-Hamel_syndrome
simpson-golabi-behmel syndrome	Simpson-Golabi-Behmel_Syndrome
sitosterolemia	Sitosterolemia
metaphyseal anadysplasia	metaphyseal_anadysplasia
metaphyseal chondrodysplasia schmid type	Metaphyseal_chondrodysplasia_type_Schmid
metaphyseal chondrodysplasia spahr type	Spahr-type_dysplasia
metatropic dwarfism	Metatropic_dysplasia
methylmalonic acidemia with homocystinuria	MMA_cblC_type_with_homocystinuria
methylmalonic aciduria cblb type	methylmalonic_aciduria_cblB_type
muenke syndrome	Muenke_syndrome
mullerian aplasia	mullerian_aplasia
neurocutaneous melanosis	Neurocutaneous_melanosis
neurofibromatosis-noonan syndrome	neurofibromatosis-Noonan_syndrome
neuronal intestinal pseudoobstruction	intestinal_myenteric_ganglia
neuronal intranuclear inclusion disease	neuronal_intranuclear_inclusion_disease
pitt-hopkins syndrome	Pitt_Hopkins_Syndrome
bruton type agammaglobulinemia	Bruton_agammaglobulinemia
burn-mckeown syndrome	BMKS
buschke-ollendorff syndrome	Buschke-Ollendorff_Syndrome
butyrylcholinesterase deficiency	butyrylcholinesterase_deficiency
apparent mineralocorticoid excess	apparent_mineralocorticoid_excess
oculomotor apraxia	oculomotor_apraxia
aromatase deficiency	Aromatase_Deficiency
arrhinia	agenesia
arterial calcification of infancy	Idiopathic_infantile_arterial_calcificationI
mehmo syndrome	MEHMO_syndrome
x-linked mental retardation-hypotonic facies syndrome	Carpenter-Waziri_syndrome
syndromic 2 microphthalmia	OFCD_syndrome
miyoshi myopathy	Miyoshi_Myopathy
autosomal recessive spastic paraplegia 11	autosomal_dominant_HSP
steatocystoma multiplex with natal teeth	natal_teeth
sternal cleft	sternal_defect
type 1 stickler syndrome	Stickler_Syndrome_type_I
type 2 stickler syndrome	types_II_and_III_Stickler_syndrome
stuve-wiedemann syndrome	Stuve-Wiedemann_syndrome
subcutaneous panniculitis-like t-cell lymphoma	Subcutaneous_panniculitis-like_T-cell_lymphoma
pleuropulmonary blastoma	Pleuropulmonary_blastoma
sclerosteosis	Sclerosteosis
seckel syndrome 1	Seckel_syndrome
microcephaly seizures mental retardation heart disorders	Severe_skeletal_defects
galloway mowat syndrome	Galloway-Mowat_Syndrome
congenital microcoria	congenital_microcoria
microgastria limb reduction defect	limb_reduction_defects
jackson-weiss syndrome	Jackson-Weiss_syndrome
jansen type metaphyseal chondrodysplasia	Jansen_type_metaphyseal_chondrodysplasia
jarcho-levin syndrome	Jarcho-Levin_syndrome
jeune syndrome	Jeune_syndrome
senior loken syndrome	Senior-Loken_syndrome
serpentine fibula polycystic kidney syndrome	serpentine_soil
severe congenital neutropenia	Severe_congenital_neutropenia
short chain acyl coa dehydrogenase deficiency	SCEH_deficiency
verma-naumoff type short rib-polydactyly syndrome	rib-polydactyly_syndrome_type_III
rhizomelic syndrome	type_of_rhizomelic_dwarfism
rhyns syndrome	RHYNS_syndrome
guanidinoacetate methyltransferase deficiency	guanidinoacetate_methyltransferase_deficiency
bjornstad syndrome	Bjornstad_syndrome
biotin-responsive basal ganglia disease	Biotin-responsive_basal_ganglia_disease
geniospasm	sporadic_geniospasm
kabuki syndrome	kabuki_syndrome
lymphedema distichiasis syndrome	Lymphedema-Distichiasis_Syndrome
pulmonary lymphangiectasia	Pulmonary_lymphangiectasia
oculocutaneous albinism type 1b	mutant-type
oculocutaneous albinism type 2	Oculocutaneous_albinism_type_2
oguchi disease	Oguchi_disease
anorchia	anorchia
antisynthetase syndrome	antisynthetase_syndrome
aorta-pulmonary artery fistula	aorta_and_pulmonary_artery
congenital primary aphakia	congenital_primary_aphakia
gerodermia osteodysplastica	Gerodermia_osteodysplastica
trisomy mosaic chromosome 7	maternal_uniparental_disomy_of_chromosome_7
macrophagic myofasciitis	Macrophagic_Myofasciitis
retinal macular dystrophy	North_Carolina_macular_dystrophy
majeed syndrome	Majeed_syndrome
norrie disease	Norrie_Disease
occipital horn syndrome	occipital_horn_syndrome
hereditary ochronosis	Hereditary_ochronosis
ocular albinism type 1	ocular_albinism_type_1
lathosterolosis	Lathosterolosis
lattice corneal dystrophy type 1	lattice_corneal_dystrophy_type_1
peters anomaly	Peters_anomaly
pfeiffer palm teller syndrome	Renner-Teller
phacomatosis pigmentokeratotica	Phacomatosis_pigmentokeratotica
bamforth syndrome	Bamforth_syndrome
barber say syndrome	Barber-Say_syndrome
femoral facial syndrome	unusual_photoacidity
fetal hydantoin syndrome	Fetal_hydantoin_syndrome
opitz-kaveggia syndrome	Opitz-Kaveggia_syndrome
finnish lethal neonatal metabolic syndrome	GRACILE-like_syndrome
mosaic trisomy chromosome 8	Mosaic_trisomy_8
cerulean cataract	Autosomal-dominant_cerulean_cataract
acute fatty liver of pregnancy	acute_fatty_liver_of_pregnancy
camptocormia	Camptocormia
camptodactyly syndrome guadalajara type 1	Area_of_Guadalajara
camptodactyly taurinuria	taurinuria
type 1c charcot-marie-tooth disease	CMT1C_disease
dopa-responsive dystonia	dopa_responsive_dystonia
eales disease	Eales_disease
meier-gorlin syndrome	Meier-Gorlin_syndrome
tetrasomy 9p chromosome 9	mosaic_tetrasomy_9p
chromosome 15 ring	ring_chromosome_15_syndrome
trisomy mosaicism chromosome 15	Partial_trisomy_15
deafness oligodontia syndrome	Oligodontia
propping zerres syndrome	ADULT_syndrome
frontometaphyseal dysplasia	frontometaphyseal_dysplasia
frontonasal dysplasia	frontonasal_dysplasia
fructosuria	Fructosuria
fryns syndrome	Fryns_syndrome
oculocerebrocutaneous syndrome	Ferro-Cerebro-Cutaneous_syndrome
type 2 oto-palato-digital syndrome	otopalatodigital_syndrome_type_2
pancreatic adenoma	pancreatic_adenoma
hereditary hyperferritinemia	hereditary_hyperferritinemia
congenital sucrase-isomaltase deficiency	congenital_sucrase-isomaltase_deficiency
filippi syndrome	Filippi_syndrome
type 2 syndactyly	Synpolydactyly
type 3 syndactyly	type_III_syndactyly
mcdonough syndrome	Feline_McDonough_Sarcoma_oncogene
mckusick kaufman syndrome	Mckusick-Kaufman_syndrome
isovaleric acidemia	Isovaleric_Acidemia
acquired angioedema	Acquired_angioedema
acrodysostosis	Acrodysostosis
acrofacial dysostosis catania form	Catania
acrofacial dysostosis rodriguez type	Rodriguez_syndrome
nager type acrofacial dysostosis	Nager_syndrome
fuhrmann syndrome	Fuhrmann_syndrome
fumaric aciduria	fumarate_reductase
familial danish dementia	familial_Danish_dementia
dent disease 1	Dent_disease-1
dentin dysplasia sclerotic bones	sclerotic_bodies
type 1 dentin dysplasia	dentin_dysplasia_type_I
adams oliver syndrome	Adams-Oliver_syndrome
adenosine monophosphate deaminase deficiency	myoadenylate_deaminase_deficiency
adenylosuccinate lyase deficiency	Adenylosuccinate_lyase_deficiency
amyopathic dermatomyositis	amyopathic_dermatomyositis
anauxetic dysplasia	anauxetic_dysplasia
congenital atransferrinemia	congenital_hypotransferrinemia
atresia of small intestine	small_intestinal_transit
familial atrial myxoma	Left_atrial_myxoma
attenuated familial adenomatous polyposis	attenuated_polyposis
auriculo-condylar syndrome	auriculocondylar_syndrome
auriculoosteodysplasia	osteodysplasia
type 1 autoimmune polyendocrinopathy syndrome	autoimmune_polyendocrine_syndrome
cataract and cardiomyopathy	Sengers_syndrome
cataract anterior polar dominant	Congenital_anterior_polar_cataract
cataract microcornea syndrome	cataract-microcornea_syndrome
trisomy 18p chromosome 18	trisomy_18p
histidinemia	histidinemia
histidinuria renal tubular defect	Histidinuria
nance-horan syndrome	Nance-Horan_syndrome
native american myopathy	Native_youth
naxos disease	Naxos_disease
potassium aggravated myotonia	sodium-channel_myotonia
potocki-shaffer syndrome	Potocki-Shaffer_syndrome
reticular dysgenesis	Reticular_dysgenesis
hyperkeratosis lenticularis perstans	hyperkeratosis_lenticularis_perstans
hyperprolinemia type 2	hyperprolinemia_type_II
congenital hypertrichosis lanuginosa	Hypertrichosis_lanuginosa
idiopathic aplastic anemia	idiopathic_aplastic_anemia
free sialic acid storage disease	lysosomal_free_sialic_acid_storage_disease
pfeiffer type acrocephalosyndactyly	Pfeiffer_and_Apert_syndromes
sporadic papillary renal cell carcinoma	sporadic_phaeochromocytomas
donath-landsteiner hemolytic anemia	Dressler-like_syndrome
idiopathic orthostatic hypotension	idiopathic_orthostatic_hypotension
low molecular weight proteinuria with hypercalciuria and nephrocalcinosis	familial_idiopathic_low_molecular_weight_proteinuria
legius syndrome	Legius_Syndrome
pontocerebellar hypoplasia type 1	pontocerebellar_hypoplasia_type_1
pontocerebellar hypoplasia type 2	pontocerebellar_hypoplasia_type_2
pontocerebellar hypoplasia type 3	pontocerebellar_hypoplasia_type_9
pontocerebellar hypoplasia type 6	Pontocerebellar_Hypoplasia_type_6
pseudohypoparathyroidism type 1b	Pseudohypoparathyroidism_type_1B
pseudohypoparathyroidism type 1c	pseudohypoparathyroidism_type_Ic
pseudohypoparathyroidism type 2	pseudohypoparathyroidism_type_I
neuroferritinopathy	neuroferritinopathy
hyperparathyroidism 1	familial_isolated_primary_hyperparathyroidism
abetalipoproteinemia	abetalipoproteinemia
achondroplasia	Achondroplasia
acrocephalosyndactylia	Apert_craniosynostosis
acromegaly	Acromegaly
addison disease	Addison_disease
adiposis dolorosa	adiposis_dolorosa
adrenocortical hyperfunction	adrenocortical_hyperfunction
congenital adrenal hyperplasia	Congenital_Adrenal_Hyperplasia
adrenoleukodystrophy	adrenoleukodystrophy
agammaglobulinemia	agammaglobulinemia
alkaptonuria	alkaptonuria
extrinsic allergic alveolitis	extrinsic_allergic_alveolitis
amelogenesis imperfecta	Amelogenesis_imperfecta
amyloidosis	amyloidosis
amyotrophic lateral sclerosis	amyotrophic_lateral-sclerosis
congenital pain insensitivity	congenital_insensitivity
ancylostomiasis	ancylostomiasis
dyserythropoietic anemia	Congenital_dyserythropoietic_anemia
hemolytic anemia	autoimmune_hemolytic_anemia
refractory anemia	refractory_anemia_with_excess_blast
sickle cell anemia	Sickle-Cell_Anemia
sideroblastic anemia	sideroblastic_anemia
fabry disease	fabry_disease
angiolymphoid hyperplasia with eosinophilia	Angiolymphoid_hyperplasia_with_eosinophilia
anodontia	Anodontia
aortic coarctation	aortic_coarctation
arachnoiditis	arachnoiditis
argyria	argyria
arteriovenous fistula	Arteriovenous_Fistula
arteriovenous malformations	Arteriovenous_Malformations
juvenile arthritis	juvenile_oligoarthritis
arthrogryposis	Arthrogryposis
aspergillosis	aspergillosis
allergic bronchopulmonary aspergillosis	Allergic_bronchopulmonary_aspergillosis
astrocytoma	Astrocytoma
ataxia telangiectasia	ataxia_Telangiectasia
babesiosis	babesiosis
balantidiasis	balantidiasis
bartonella infections	Bartonella_infection
bartter syndrome	Bartter_Syndrome
beckwith-wiedemann syndrome	Beckwith_Wiedemann_syndrome
behcet syndrome	Behcet_s_disease
bernard-soulier syndrome	Bernard-Soulier_Syndrome
berylliosis	berylliosis
bile duct neoplasms	bile_duct_neoplasms
biliary atresia	biliary_atresia
bird fancier's lung	retired_breeder
bladder exstrophy	Cloacal_Exstrophy
blepharoptosis	Blepharoptosis
bloom syndrome	bloom_syndrome
botulism	Botulism
boutonneuse fever	Boutonneuse_fever
bronchogenic cyst	bronchogenic_cyst
bronchopulmonary dysplasia	Bronchopulmonary_Dysplasia
brucellosis	brucellosis
burkitt lymphoma	Burkitt_Lymphoma
chronic mucocutaneous candidiasis	Chronic_Mucocutaneous_Candidiasis
renal cell carcinoma	Renal_Cell_carcinoma
dilated cardiomyopathy	Dilated_Cardiomyopathy
hypertrophic cardiomyopathy	Familial_hypertrophic_cardiomyopathy
restrictive cardiomyopathy	restrictive_allograft_syndrome
cat-scratch disease	cat_scratch_disease
intracranial arteriovenous malformations	intracranial_arteriovenous_malformations
diffuse cerebral sclerosis of schilder	diseases_like_Alpers_syndrome
charcot-marie-tooth disease	Charcot_Marie_Tooth_Disease
chediak-higashi syndrome	Chediak_Higashi_syndrome
cherubism	Cherubism
pervasive child development disorders	pervasive_developmental_disorders
choanal atresia	Choanal_atresia
cholera	cholera
chondrodysplasia punctata	Cooperia_punctata
chondrosarcoma	Chondrosarcoma
chordoma	chordoma
chorea	Chorea
hemophilia b	Hemophilia-B
chromoblastomycosis	chromoblastomycosis
chromosome aberrations	Chromosome_Aberrations
chylous ascites	chylous_ascites
cleft palate	Cleft_Palate
cleidocranial dysplasia	cleidocranial_dysplasia
coccidioidomycosis	Coccidioidomycosis
cockayne syndrome	Cockayne_syndrome
hereditary nonpolyposis colorectal neoplasms	hereditary_nonpolyposis_colorectal_tumors
hereditary corneal dystrophies	hereditary_corneal_dystrophies
craniopharyngioma	craniopharyngioma
craniosynostoses	craniosynostosis
congenital hypothyroidism	Congenital_Hypothyroidism
cri-du-chat syndrome	Anti-ChAT_2
crigler-najjar syndrome	Crigler-Najjar_Syndrome
cryptococcosis	Cryptococcosis
cushing syndrome	cushing_syndrome
cutis laxa	Cutis_laxa
cystic fibrosis	cystic_fibrosis
cysticercosis	Cysticercosis
cystinosis	Cystinosis
cystinuria	Cystinuria
phyllodes tumor	cystosarcoma_phyllodes
de lange syndrome	cornelia_de_Lange_syndrome
dengue	Dengue
dentin dysplasia	dentin_dysplasia
dentinogenesis imperfecta	Dentinogenesis_imperfecta
dermatitis herpetiformis	Dermatitis_Herpetiformis
dermatomyositis	dermatomyositis
dextrocardia	dextrocardia
camurati-engelmann syndrome	camurati-engelmann_disease
vipoma	vipoma
diphtheria	diphtheria
dirofilariasis	dirofilariasis
double outlet right ventricle	double-outlet_right_ventricle
down syndrome	Down_Syndrome
dracunculiasis	dracunculiasis
duane retraction syndrome	Duane_retraction_syndrome
familial dysautonomia	Familial_dysautonomia
echinococcosis	Echinococcosis
ectodermal dysplasia	ectodermal_dysplasia
ectopia lentis	Ectopia_lentis
ehlers-danlos syndrome	Ehlers-danlos_syndrome
hereditary elliptocytosis	Hereditary_elliptocytosis
ellis-van creveld syndrome	Ellis-van_Creveld_syndrome
encephalitis	Encephalitis
california encephalitis	California_encephalitis
japanese encephalitis	Japanese_encephalitis
st. louis encephalitis	Louis_encephalitis
tick-borne encephalitis	Tick-borne_encephalitis
encephalocele	encephalocele
enchondromatosis	enchondromatosis
epidermodysplasia verruciformis	Epidermodysplasia_verruciformis
epispadias	epispadias
esophageal atresia	esophageal_atresia
fanconi anemia	Fanconi_anemia
felty syndrome	Felty_syndrome
fibrosarcoma	fibrosarcoma
fibrous dysplasia of bone	Fibrous_dysplasia_of_bone
monostotic fibrous dysplasia	monostotic_fibrous_dysplasia
polyostotic fibrous dysplasia	Polyostotic_Fibrous_Dysplasia
filariasis	filariasis
focal dermal hypoplasia	Focal_dermal_hypoplasia
fragile x syndrome	fragile_X_Syndrome
friedreich ataxia	friedreich_ataxia
fructose intolerance	Hereditary_fructose_intolerance
fucosidosis	Fucosidosis
galactosemias	Galactosemia
gardner syndrome	Gardner_syndrome
gaucher disease	gaucher_disease
gerstmann syndrome	Gerstmann_syndrome
castleman disease	Castleman_Disease
gigantism	Gigantism
glioblastoma	glioblastoma
glioma	glioma
glucagonoma	Glucagonoma
glycogen storage disease	glycogen-storage_disease
glycogen storage disease type ii	Glycogen-storage_disease_type_II
glycogen storage disease type v	glycogen_storage_disease_type_V
goldenhar syndrome	Goldenhar_syndrome
graft vs host disease	Graft-Vs-Host_Disease
chronic granulomatous disease	Chronic_Granulomatous_Disease
granulosa cell tumor	Granulosa_Cell_Tumor
pantothenate kinase-associated neurodegeneration	pantothenate_kinase-associated_neurodegeneration
multiple hamartoma syndrome	PTEN_tumor_hamartoma_syndrome
hartnup disease	Hartnup_disease
atrial heart septal defects	atrial_septal_defects
heavy chain disease	heavy_chain_disease
hemangiopericytoma	Hemangiopericytoma
hemoglobin c disease	hemoglobin_SS
hemoglobinopathies	Hemoglobinopathies
paroxysmal hemoglobinuria	paroxysmal_cold_hemoglobinuria
hemophilia a	Hemophilia_A
hemorrhagic fever with renal syndrome	hemorrhagic_fever_with_renal_syndrome
budd-chiari syndrome	Budd-Chiari_Syndrome
hepatic veno-occlusive disease	hepatic_veno-occlusive_disease
hepatolenticular degeneration	Hepatolenticular_Degeneration
hepatocellular carcinoma	HEPATOCELLULAR_CARCINOMA
pemphigoid gestationis	pemphigoid_gestationis
von hippel-lindau disease	Von_Hippel-Lindau_Disease
hirschsprung disease	hirschsprung_disease
langerhans-cell histiocytosis	Langerhans_cell_Histiocytosis
histoplasmosis	histoplasmosis
hodgkin disease	Hodgkin_Disease
hookworm infections	hookworm_infections
huntington disease	huntington_disease
hydatidiform mole	Hydatidiform_Mole
hydranencephaly	Hydranencephaly
hymenolepiasis	Hymenolepiasis
hyperlipoproteinemia type iii	hyperlipoproteinemia_type_III
hyperoxaluria	hyperoxaluria
hypertrichosis	hypertrichosis
hypobetalipoproteinemias	Hypobetalipoproteinemia
hypophosphatasia	Hypophosphatasia
ichthyosis	Ichthyosis
incontinentia pigmenti	Incontinentia_pigmenti
insulinoma	insulinoma
creutzfeldt-jakob syndrome	Creutzfeldt-Jakob-like_syndrome
chronic idiopathic jaundice	chronic_idiopathic_DCM
kearns-sayre syndrome	kearns-sayre_syndrome
darier disease	Darier_disease
medullary sponge kidney	medullary_sponge_kidney
klinefelter syndrome	Klinefelter_syndrome
klippel-trenaunay-weber syndrome	Klippel-Trenaunay-Weber_syndrome
larva migrans	larva_migrans
lassa fever	Lassa_fever
legionellosis	Legionellosis
legionnaires' disease	Legionnaires_disease
leigh disease	Leigh_disease
leiomyosarcoma	leiomyosarcoma
leishmaniasis	leishmaniasis
leprosy	Leprosy
leptospirosis	Leptospirosis
lesch-nyhan syndrome	Lesch_Nyhan_syndrome
hairy cell leukemia	hairy_Cell_leukemia
mast-cell leukemia	Mast_cell_leukemia
monocytic leukemia	Acute_monocytic_leukemia
metachromatic leukodystrophy	METACHROMATIC_LEUKODYSTROPHY
progressive multifocal leukoencephalopathy	Progressive_multifocal_leukoencephalopathy
mucopolysaccharidosis i	Mucopolysaccharidosis_I
whipple disease	Whipple_disease
liposarcoma	LipoSarcoma
listeriosis	Listeriosis
loiasis	loiasis
cutaneous lupus erythematosus	Cutaneous_Lupus_Erythematosus
discoid lupus erythematosus	Discoid_lupus_erythematosus
systemic lupus erythematosus	systemic_Lupus_erythematosus
lyme disease	Lyme_Disease
intestinal lymphangiectasis	Intestinal_lymphangiectasis
lymphoma	LYmphoma
follicular lymphoma	follicular_lymphoma
non-hodgkin lymphoma	nonHodgkin_lymphoma
lymphomatoid granulomatosis	lymphomatoid_granulomatosis
lymphoproliferative disorders	Lymphoproliferative_Disorders
waldenstrom macroglobulinemia	Waldenstrom_macroglobulinemia
macroglossia	Macroglossia
mycetoma	Mycetoma
malaria	malaria
malignant hyperthermia	Malignant_hyperthermia
mandibulofacial dysostosis	Mandibulofacial_Dysostosis
alpha-mannosidosis	Alpha-mannosidosis
maple syrup urine disease	maple_syrup_urine_disease
marfan syndrome	Marfan_syndrome
mastocytosis	mastocytosis
meconium aspiration syndrome	meconium-aspiration_syndrome
medulloblastoma	Medulloblastoma
meige syndrome	Meige_syndrome
melioidosis	Melioidosis
melkersson-rosenthal syndrome	Melkersson-Rosenthal_Syndrome
melorheostosis	Melorheostosis
meningioma	Meningioma
meningococcal meningitis	Meningococcal_meningitis
pneumococcal meningitis	Pneumococcal_meningitis
meningocele	rudimentary_ribs_remained
mesothelioma	mesothelioma
metabolic diseases	metabolic_diseases
inborn errors metabolism	Inborn_errors_of_metabolism
mikulicz' disease	Mikulicz_disease
mixed connective tissue disease	Mixed_connective_tissue_disease
moyamoya disease	moyamoya_disease
mucolipidoses	mucolipidoses_I
mucopolysaccharidoses	Mucopolysaccharidoses
mucopolysaccharidosis iii	Mucopolysaccharidosis_III
mucopolysaccharidosis iv	mucopolysaccharidosis_IVA
mucopolysaccharidosis vi	Mucopolysaccharidosis_VI
mucormycosis	mucormycosis
multiple carboxylase deficiency	Multiple_carboxylase_deficiency
multiple myeloma	multiple_myeloma
muscular diseases	muscular_diseases
muscular dystrophies	Muscular_dystrophies
myasthenia gravis	Myasthenia_gravis
myelodysplastic syndromes	myelodysplastic_syndromes
myeloproliferative disorders	myeloproLiferative_disorders
myiasis	Myiasis
cardiomyopathies	Cardiomyopathies
myositis ossificans	Myositis_Ossificans
myotonic dystrophy	Myotonic_Dystrophy
nail-patella syndrome	Nail_patella_syndrome
narcolepsy	Narcolepsy
nelson syndrome	Nelson_syndrome
hereditary nephritis	hereditary_nephritis
wilms tumor	Wilms_Tumor
neural tube defects	Neural_Tube_Defects
neuroblastoma	Neuroblastoma
neurofibromatosis 1	neurofibromatosis_1
neuroleptic malignant syndrome	Neuroleptic_malignant_syndrome
acoustic neuroma	Acoustic_Neuroma
neuromuscular diseases	neuromuscular_diseases
neuromyelitis optica	neuromyelitis_optica
neuronal ceroid-lipofuscinoses	Neuronal_ceroid_lipofuscinoses
hereditary sensory and autonomic neuropathies	Hereditary_sensory_radicular_neuropathy
noma	noma
noonan syndrome	Noonan_Syndrome
oculocerebrorenal syndrome	oculocerebrorenal_syndrome
onchocerciasis	onchocerciasis
endophthalmitis	endophthalmitis
sympathetic ophthalmia	Sympathetic_ophthalmia
primary hypertrophic osteoarthropathy	Primary_Hypertrophic_Osteoarthropathy
osteochondritis dissecans	osteochondritis_dissecans
osteogenesis imperfecta	osteogenesis_Imperfecta
osteopetrosis	Osteopetrosis
extramammary paget disease	vulvar_extramammary_Paget_disease
pancreatic neoplasms	Pancreatic_neoplasms
nodular nonsuppurative panniculitis	Nodular_panniculitis
papillon-lefevre disease	Papillon-Lefevre_syndrome
paracoccidioidomycosis	paracoccidioidomycosis
progressive bulbar palsy	acute_bulbar_palsy-like_syndrome
familial periodic paralyses	familial_periodic_paralysis
pellagra	Pellagra
bullous pemphigoid	Bullous_Pemphigoid
polyarteritis nodosa	Polyarteritis_Nodosa
familial mediterranean fever	Familial_mediterranean_fever
peutz-jeghers syndrome	Peutz-Jeghers_Syndrome
phenylketonurias	Phenylketonuria
pituitary apoplexy	pituitary_apoplexy
pityriasis rubra pilaris	Pityriasis_Rubra_Pilaris
plague	plague
plasmacytoma	Plasmacytoma
plummer-vinson syndrome	plummer-vinson_syndrome
pneumoconiosis	Pneumoconiosis
rothmund-thomson syndrome	Rothmund-Thomson_Syndrome
poland syndrome	Moebius-Poland_syndrome
poliomyelitis	Poliomyelitis
relapsing polychondritis	Relapsing_polychondritis
polycythemia	polycythemia
polycythemia vera	polycythemia_vera
polyploidy	Polyploidy
adenomatous polyposis coli	Adenomatous_Polyposis_Coli
porphyrias	porphyrias
prader-willi syndrome	prader-willi_Syndrome
progeria	progeria
prune belly syndrome	prune-belly_syndrome
pseudohypoaldosteronism	pseudohypoaldosteronism
pseudohypoparathyroidism	pseudohypoparathyroidism
pseudomyxoma peritonei	Pseudomyxoma_peritonei
pseudopseudohypoparathyroidism	pseudopseudohypoparathyroidism
pseudoxanthoma elasticum	Pseudoxanthoma_elasticum
precocious puberty	Precocious_puberty
pulmonary valve stenosis	pulmonary_valve_stenosis
pulmonary veno-occlusive disease	pulmonary_venoocclusive_disease
inborn errors purine-pyrimidine metabolism	disorders_of_purine_and_pyrimidine_metabolism
thrombotic thrombocytopenic purpura	Thrombotic_thrombocytopenic_Purpura
q fever	Q-fever
rabies	rabies
rat-bite fever	rat-bite_fever
refsum disease	Refsum_disease
relapsing fever	tick-borne_relapsing_fever
retinitis pigmentosa	retinitis_pigmentosa
retinoblastoma	Retinoblastoma
retinopathy of prematurity	Retinopathy_of_prematurity
retroperitoneal fibrosis	retroperitoneal_fibrosis
reye syndrome	Reye_syndrome
rhabdomyosarcoma	rhabdomyosarcoma
rheumatic fever	Rheumatic_Fever
rocky mountain spotted fever	Rocky_Mountain_spotted_fever
congenital rubella syndrome	congenital_rubella_syndrome
rubinstein-taybi syndrome	Rubinstein_Taybi_Syndrome
sandhoff disease	Sandhoff_Disease
sarcoidosis	Sarcoidosis
kaposi sarcoma	Kaposi_Sarcoma
mast-cell sarcoma	mast_cell_sarcoma
osteosarcoma	Osteosarcoma
sarcocystosis	sarcocystosis
schistosomiasis	schistosomiasis
scimitar syndrome	scimitar_syndrome
localized scleroderma	Localized_Scleroderma
scrub typhus	Scrub_typhus
disorders of sex development	Disorders_of_Sex_Development
sezary syndrome	Sezary_Syndrome
short bowel syndrome	Short_bowel_syndrome
short rib-polydactyly syndrome	short_rib_polydactyly_syndrome
sick sinus syndrome	sick_sinus_syndrome
sleep wake disorders	sleep-wake_disorders
somatostatinoma	Somatostatinoma
hereditary spherocytosis	hereditary_spherocytosis
sphingolipidoses	sphingolipidoses
sporotrichosis	sporotrichosis
staphylococcal scalded skin syndrome	staphylococcal_scalded_skin_syndrome
stevens-johnson syndrome	Stevens-Johnson_Syndrome
strongyloidiasis	Strongyloidiasis
sturge-weber syndrome	Sturge-Weber_syndrome
progressive supranuclear palsy	progressive_supranuclear_palsy
syndactyly	syndactyly
pigmented villonodular synovitis	pigmented_villonodular_synovitis
syringomyelia	Syringomyelia
takayasu arteritis	Takayasu_Arteritis
tangier disease	Tangier_Disease
tay-sachs disease	Tay_Sachs_disease
giant cell arteritis	giant-cell_arteritis
teratoma	Teratoma
androgen-insensitivity syndrome	Androgen_Insensitivity_Syndrome
tetanus	tetanus
tetralogy of fallot	tetralogy_of_fallot
thoracic outlet syndrome	Thoracic_Outlet_Syndrome
essential thrombocythemia	essential_thrombocythemia
thymoma	Thymoma
toxocariasis	Toxocariasis
congenital toxoplasmosis	Congenital_toxoplasmosis
trench fever	trenches
trichinellosis	trichinellosis
trigeminal neuralgia	Trigeminal_neuralgia
trisomy	trisomy
african trypanosomiasis	African_trypanosomiasis
tuberculosis	TUBERCULOSIS
tuberous sclerosis	TuberOus_SClerosis
tularemia	tularemia
turner syndrome	turner_syndrome
epidemic louse-borne typhus	Epidemic_Louse-borne_Typhus_Fever
urachal cyst	urachal_cyst
urticaria pigmentosa	Urticaria_pigmentosa
uveitis	UVEitis
vasculitis	vasculitis
von willebrand diseases	Von_Willebrand_Disease
waardenburg syndrome	waardenburg_syndrome
waterhouse-friderichsen syndrome	Waterhouse-Friderichsen_syndrome
granulomatosis with polyangiitis	granulomatosis
werner syndrome	Werner_syndrome
whooping cough	whooping_cough
wiskott-aldrich syndrome	Wiskott_Aldrich_Syndrome
wolfram syndrome	wolfram_syndrome
juvenile xanthogranuloma	Juvenile_Xanthogranuloma
xeroderma pigmentosum	Xeroderma_Pigmentosum
yellow fever	yellow_fever
yersinia infections	Yersinia_infections
zollinger-ellison syndrome	zollinger-ellison_syndrome
hydrops fetalis	Hydrops_fetalis
prolactinoma	prolactinoma
zellweger syndrome	Zellweger_syndrome
wolman disease	Wolman_Disease
churg-strauss syndrome	Churg-Strauss-Syndrome
pyruvate carboxylase deficiency disease	pyruvate_carboxylase_deficiency
pyruvate dehydrogenase complex deficiency disease	pyruvate_dehydrogenase_complex_deficiency
neovascular glaucoma	Neovascular_Glaucoma
gastrinoma	gastrinoma
membranoproliferative glomerulonephritis	type_I_membranoproliferative_glomerulonephritis
lupus erythematosus panniculitis	Lupus_erythematosus_panniculitis
lymphocytic leukemia	lymphatic_leukemia
biphenotypic leukemia	biphenotypic_leukemia
adult t-cell leukemia-lymphoma	Adult_T-Cell_Leukemia-Lymphoma
prolymphocytic leukemia	B_prolymphocytic_leukemia
neutrophilic leukemia	Chronic_Neutrophilic_Leukemia
myeloid leukemia	Atypical_chronic_myeloid_leukemia
basophilic leukemia	Basophilic_Leukemia
promyelocytic leukemia	ProMyelocytic_Leukemia
myelomonocytic leukemia	myelomonocytic_leukemia
rett syndrome	rett_syndrome
non-langerhans-cell histiocytosis	Reticulohistiocytomas
lambert-eaton myasthenic syndrome	lambert-eaton_myasthenic_syndrome
choroideremia	CHOROIDEREMIA
acanthamoeba keratitis	acanthamoeba_keratitis
langer-giedion syndrome	Langer-Giedion_syndrome
ocular onchocerciasis	ocular_onchocerciasis
arachnoid cysts	arachnoid_cysts
gerstmann-straussler-scheinker disease	Gerstmann-Straussler-Scheinker_disease
junctional epidermolysis bullosa	Junctional_epidermolysis_bullosa
sjogren-larsson syndrome	gren-Larsson_syndrome
x-linked ichthyosis	X-Linked_Ichthyosis
oculocutaneous albinism	Oculocutaneous_albinism
piebaldism	Piebaldism
spinal dysraphism	spinal_dysraphism
holoprosencephaly	holoprosencephaly
large b-cell lymphoma	diffuse_large_b-cell_lymphoma
t-cell lymphoma	Peripheral_T-cell_lymphoma
sweet syndrome	sweet_syndrome
ovarian hyperstimulation syndrome	ovarian_hyperstimulation_syndrome
motor neuron disease	Motor_Neuron_Disease
severe combined immunodeficiency	severe-combined_immunodeficiency
neurofibromatosis 2	neurofibromatosis-2
mucopolysaccharidosis ii	mucopolysaccharidosis_II
gm1 gangliosidosis	GM1_Gangliosidosis
mucopolysaccharidosis vii	mucopolysaccharidosis_VII
thrombocytopenic purpura	Immune_Thrombocytopenic_Purpura
eosinophilia-myalgia syndrome	Eosinophilia-Myalgia_Syndrome
adult-onset still's disease	Adult-Onset_Still_Disease
proteus syndrome	proteus_syndrome
alagille syndrome	alagille_syndrome
caroli disease	Caroli_disease
li-fraumeni syndrome	Li_Fraumeni_Syndrome
ehrlichiosis	Ehrlichiosis
poems syndrome	POEMS_syndrome
microsporidiosis	Microsporidiosis
reactive arthritis	Reiter
autosomal recessive polycystic kidney	autosomal_recessive_polycystic_kidneys
common variable immunodeficiency	Common_Variable_ImmunoDeficiency
alpha-thalassemia	Alpha-thalassemia
beta-thalassemia	Beta_Thalassemia
acute liver failure	Acute_liver_failure
acute intermittent porphyria	Acute_Intermittent_Porphyria
porphyria cutanea tarda	Porphyria_Cutanea_Tarda
hepatoerythropoietic porphyria	Hepatoerythropoietic_Porphyria
anisakiasis	anisakiasis
angelman syndrome	Angelman_Syndrome
mitochondrial myopathies	mitochondrial_myopathies
melas syndrome	MELAS_syndrome
merrf syndrome	MERRF_syndrome
polymyositis	Polymyositis
hellp syndrome	HELLP-syndrome
kallmann syndrome	kallmann_syndrome
vascular skin diseases	chronic_skin_complications
lamellar ichthyosis	lamellar_ichthyosis
porokeratosis	porokeratosis
pyoderma gangrenosum	Pyoderma_GAngrenosum
interstitial lung diseases	Interstitial_Lung_Diseases
kleine-levin syndrome	Kleine-Levin_syndrome
wagr syndrome	WAGR_syndrome
crest syndrome	CREST_syndrome
hypereosinophilic syndrome	hypereosinophilic_syndrome
polydactyly	Polydactyly
nemaline myopathies	nemaline_myopathy
large-cell lymphoma	Anaplastic_large_cell_lymphoma
lymphomatoid papulosis	lymphomatoid_papulosis
canavan disease	Canavan_Disease
lymphangioleiomyomatosis	lymphangioleiomyomatosis
hepatoblastoma	Hepatoblastoma
mesoblastic nephroma	Mesoblastic_nephroma
pulmonary blastoma	pulmonary_blastoma
endometrial stromal sarcoma	Endometrial_stromal_sarcoma
myxoid liposarcoma	Myxoid_liposarcoma
osteoblastoma	Osteoblastoma
alveolar rhabdomyosarcoma	alveolar_Rhabdomyosarcoma
embryonal rhabdomyosarcoma	Embryonal_Rhabdomyosarcoma
alveolar soft part sarcoma	Alveolar_soft_part_sarcoma
germinoma	Germinoma
placental site trophoblastic tumor	placental_site_trophoblastic_tumor
liver cell adenoma	liver_cell_adenoma
adrenocortical carcinoma	Adrenocortical_Carcinoma
cholangiocarcinoma	Cholangiocarcinoma
klatskin tumor	klatskin_tumor
pilomatrixoma	pilomatrixoma
epithelioid hemangioendothelioma	epithelioid_hemangioendothelioma
rhabdoid tumor	rhabdoid_tumor
leukocyte-adhesion deficiency syndrome	Leukocyte_adhesion_deficiency_PMN
b-cell lymphoma	MALT-lymphoma
nephrogenic diabetes insipidus	nephrogenic_diabetes_insipidus
cryptogenic organizing pneumonia	Cryptogenic_organizing_pneumonia
hypoplastic left heart syndrome	Hypoplastic_Left_Heart_Syndrome
multiple endocrine neoplasia type 1	Multiple_Endocrine_Neoplasia_type_1
tricuspid atresia	Tricuspid_Atresia
multiple endocrine neoplasia type 2a	Multiple_endocrine_neoplasia_type_2a
multiple endocrine neoplasia type 2b	multiple_endocrine_neoplasia_type_2b
interstitial cystitis	interstitial_cystitis
sneddon syndrome	Sneddon_syndrome
landau-kleffner syndrome	Landau-kleffner_syndrome
primary progressive aphasia	primary_progressive_aphasia
peroxisomal disorders	peroxisomal_disorders
rhizomelic chondrodysplasia punctata	Rhizomelic_Chondrodysplasia_Punctata
williams syndrome	Williams_Syndrome
smith-lemli-opitz syndrome	Smith_Lemli_Opitz_syndrome
branchio-oto-renal syndrome	branchiootorenal_syndrome
cerebrotendinous xanthomatosis	Cerebrotendinous_Xanthomatosis
port-wine stain	portwine_stains
pouchitis	pouchitis
capillary leak syndrome	capillary_leak_syndrome
arrhythmogenic right ventricular dysplasia	arrhythmogenic_right_ventricular_dysplasia
multiple system atrophy	Multiple-system_atrophy
premature aging	premature_aging
miller fisher syndrome	Miller_Fisher_Syndrome
dyskeratosis congenita	Dyskeratosis_Congenita
schnitzler syndrome	Schnitzler_Syndrome
alpha 1-antitrypsin deficiency	Alpha-1-antitrypsin_deficiency
zygomycosis	zygomycosis
gastroschisis	gastroschisis
citrullinemia	citrullinemia
hyperargininemia	Hyperargininemia
ornithine carbamoyltransferase deficiency disease	Ornithine_transcarbamylase_deficiency
hyperlysinemias	Hyperlysinemia
juvenile myoclonic epilepsy	Juvenile_Myoclonic_Epilepsy
progressive myoclonic epilepsies	progressive_myoclonic_epilepsy
lafora disease	Lafora_Disease
unverricht-lundborg syndrome	Unverricht-Lundborg_PME
reflex epilepsy	Reflex_epilepsy
serotonin syndrome	Serotonin_Syndrome
kluver-bucy syndrome	Kluver-Bucy_syndrome
guillain-barre syndrome	guillain-barre_syndrome
choroid plexus papilloma	choroid_plexus_papilloma
central nervous system vasculitis	Central_nervous_system_vasculitis
congenital myasthenic syndromes	Congenital_myasthenic_syndromes
tolosa-hunt syndrome	Tolosa-Hunt_syndrome
pelizaeus-merzbacher disease	pelizaeus-merzbacher_disease
duchenne muscular dystrophy	DUCHENNE_MUSCULAR_DYSTROPHY
emery-dreifuss muscular dystrophy	Emery_Dreifuss_Muscular_Dystrophy
neuromuscular junction diseases	neuromuscular_junction_disorders
hyperkalemic periodic paralysis	Hyperkalemic_periodic_paralysis
hypokalemic periodic paralysis	Hypokalemic_periodic_paralysis
mantle-cell lymphoma	Mantle-cell_lymphoma
bardet-biedl syndrome	Bardet-Biedl_Syndrome
neurogenic diabetes insipidus	cranial_diabetes_insipidus
benign neonatal epilepsy	benign_neonatal_epilepsy
myotonic disorders	myotonic_disorders
multicystic dysplastic kidney	multicystic_dysplastic_kidney
isosporiasis	isosporiasis
supravalvular aortic stenosis	Supravalvular_aortic_stenosis
myeloid sarcoma	Myeloid_Sarcoma
septo-optic dysplasia	septooptic_dysplasia
familial cerebral amyloid angiopathy	familial_cerebral_amyloid_angiopathy
mitochondrial diseases	Mitochondrial_diseases
biotinidase deficiency	biotinidase_deficiency
holocarboxylase synthetase deficiency	Holocarboxylase_synthetase_deficiency
autosomal dominant optic atrophy	Optic_atrophy_type_1
diamond-blackfan anemia	Diamond-Blackfan_Anemia
jervell-lange nielsen syndrome	Jervell-Lange-Nielsen_syndrome
romano-ward syndrome	Romano-Ward_syndrome
denys-drash syndrome	Denys-Drash_Syndrome
erdheim-chester disease	Erdheim-Chester_Disease
hajdu-cheney syndrome	Hajdu_Cheney_syndrome
gestational trophoblastic disease	Gestational_trophoblastic_disease
fatal familial insomnia	Fatal_familial_insomnia
cutaneous mastocytosis	Cutaneous_mastocytosis
systemic mastocytosis	Systemic_Mastocytosis
alexander disease	Alexander-disease
coffin-lowry syndrome	Coffin-Lowry_Syndrome
oculopharyngeal muscular dystrophy	oculopharyngeal_muscular_dystrophy
apparent mineralocorticoid excess syndrome	mineralocorticoid_excess_syndrome
intestinal polyposis	intestinal_polyposis
leopard syndrome	LEOPARD_syndrome
congenital hyperinsulinism	Congenital_hyperinsulinism
beta-mannosidosis	beta-mannosidosis
severe acute respiratory syndrome	Severe_Acute_Respiratory_Syndrome
laron syndrome	laron_syndrome
gastrointestinal stromal tumors	GASTROINTESTINAL_STROMAL_TUMORS
hereditary coproporphyria	hereditary_coproporphyria
erythropoietic protoporphyria	erythropoietic_protoporphyria
cadasil	CADASIL
pituitary acth hypersecretion	ACTH_hypersecretion
adrenogenital syndrome	adrenogenital_syndrome
limb-girdle muscular dystrophies	limb-girdle_muscular_dystrophies
nijmegen breakage syndrome	nijmegen_breakage_syndrome
ovotesticular disorders of sex development	ovotesticular_DSD
mulibrey nanism	mulibrey_nanism
adamantinoma	adamantinoma
sunct syndrome	SUNCT-syndrome
paroxysmal hemicrania	paroxysmal_hemicrania
trigeminal autonomic cephalalgias	autonomic_cephalalgias
malignant fibrous histiocytoma	Malignant_fibrous_histiocytoma
frasier syndrome	Frasier_Syndrome
usher syndromes	Usher_syndromes
hypoalphalipoproteinemias	hypoalphalipoproteinemia
familial partial lipodystrophy	familial_partial_lipodystrophy
type a niemann-pick disease	Niemann-Pick_A_disease
type b niemann-pick disease	Niemann-Pick_type_B_disease
type c niemann-pick disease	Type_C_Niemann-Pick_disease
pyomyositis	Pyomyositis
infantile refsum disease	Infantile_Refsum_disease
anhidrotic ectodermal dysplasia 1	hypohidrotic_ectodermal_dysplasia
hypohidrotic ectodermal dysplasia	hypohidrotic_ectodermal_dysplasia
pachyonychia congenita	pachyonychia_congenita
juvenile epithelial of meesmann corneal dystrophy	Meesmann_corneal_dystrophy
ichthyosis bullosa of siemens	ichthyosis_bullosa_of_Siemens
opsoclonus-myoclonus syndrome	Opsoclonus-Myoclonus_Syndrome
gitelman syndrome	Gitelman_Syndrome
scleromyxedema	Scleromyxedema
brugada syndrome	Brugada_syndrome
sebaceous of jadassohn nevus	verrucous_epidermal_nevus
large granular lymphocytic leukemia	Large_granular_lymphocytic_leukemia
dihydropyrimidine dehydrogenase deficiency	dihydropyrimidine_dehydrogenase_deficiency
mevalonate kinase deficiency	Mevalonate_kinase_deficiency
lissencephaly	Lissencephaly
periventricular nodular heterotopia	Periventricular_nodular_heterotopia
classical lissencephalies and subcortical band heterotopias	lissencephaly-subcortical_band_heterotopia
marchiafava-bignami disease	Marchiafava-Bignami_Disease
extranodal nk-t-cell lymphoma	Extranodal_MZL
myelodysplastic-myeloproliferative diseases	myelodysplastic_and_myeloproliferative_disorders
primary cutaneous anaplastic large cell lymphoma	Primary_cutaneous_anaplastic_large_cell_lymphoma
trichothiodystrophy syndromes	Trichothiodystrophy
persistent hyperplastic primary vitreous	persistent_hyperplastic_primary_vitreous_formation
primary effusion lymphoma	primary_effusion_lymphoma
skin mastocytoma	solitary_mastocytoma
interdigitating dendritic cell sarcoma	interdigitation
follicular dendritic cell sarcoma	follicular_dendritic_cell_sarcoma
histiocytic sarcoma	histiocytic_sarcoma
langerhans cell sarcoma	Langerhans_cell_sarcoma
malignant atrophic papulosis	Malignant_atrophic_papulosis
jacobsen distal 11q deletion syndrome	Jacobsen_syndrome
wolf-hirschhorn syndrome	Wolf-Hirschhorn_Syndrome
aspartylglucosaminuria	Aspartylglucosaminuria
pure autonomic failure	pure_autonomic_failure
pallister-hall syndrome	Pallister-Hall_syndrome
idiopathic interstitial pneumonias	idiopathic_interstitial_pneumonias
idiopathic pulmonary fibrosis	idiopathic_pulmonary_fibrosis
campomelic dysplasia	Campomelic_Dysplasia
laryngomalacia	Laryngomalacia
acute lung injury	Acute_Lung_Injury
macrophage activation syndrome	macrophage-activation_syndrome
farber lipogranulomatosis	Farber_Lipogranulomatosis
gray platelet syndrome	Gray_platelet_syndrome
muir-torre syndrome	Muir-Torre_Syndrome
purpura fulminans	purpura_fulminans
cogan syndrome	Cogan_syndrome
microscopic polyangiitis	Microscopic_Polyangiitis
susac syndrome	Susac_syndrome
pagetoid reticulosis	Pagetoid_Reticulosis
cryopyrin-associated periodic syndromes	Cryopyrin-associated_periodic_syndromes
systemic vasculitis	Systemic_vasculitis
anti-neutrophil cytoplasmic antibody-associated vasculitis	ANCA_associated_vasculitis
costello syndrome	Costello_Syndrome
propionic acidemia	Propionic_Acidemia
type 1 von willebrand disease	type_1_von_Willebrand_Disease
type 2 von willebrand disease	type_2_von_Willebrand_disease
type 3 von willebrand disease	Type_3_von_Willebrand_disease
silver-russell syndrome	Silver_Russell_syndrome
donohue syndrome	Donohue_syndrome
prolidase deficiency	Prolidase_Deficiency
carney complex	Carney_Complex
autoimmune lymphoproliferative syndrome	autoimmune-lymphoproliferative_syndrome
giant axonal neuropathy	giant_axonal_neuropathy
alstrom syndrome	Alstrom_syndrome
argininosuccinic aciduria	Argininosuccinic_aciduria
hereditary angioedema type iii	hereditary_angioedema_type_III
weill-marchesani syndrome	Weill-Marchesani_Syndrome
barth syndrome	Barth_syndrome
liddle syndrome	Liddle_syndrome
thrombotic microangiopathies	Thrombotic_microangiopathies
iridocorneal endothelial syndrome	Iridocorneal_Endothelial_Syndrome
leber congenital amaurosis	Leber_Congenital_Amaurosis
primary progressive nonfluent aphasia	non-fluent_aphasia
frontotemporal dementia	Frontotemporal_Dementia
systemic hyalinosis	Systemic_hyalinosis
lemierre syndrome	Lemierre_syndrome
triploidy	triploidy
tetraploidy	tetraploidy
dent disease	Dent_disease
loose anagen hair syndrome	loose_anagen_hair_syndrome
birt-hogg-dube syndrome	Birt-Hogg-Dube_syndrome
necrobiotic xanthogranuloma	Necrobiotic_Xanthogranuloma
tungiasis	Tungiasis
desmoplastic small round cell tumor	desmoplastic_small-round-cell_tumor
retinal telangiectasis	retinal_telangiectasis
xx disorders of sex development 46	XX_DSD
46 disorder of sex development	XY-sex_reversal_syndrome
walker-warburg syndrome	Walker-Warburg_Syndrome
sotos syndrome	Sotos_Syndrome
smith-magenis syndrome	Smith-Magenis_Syndrome
fraser syndrome	Fraser_Syndrome
retinal dystrophies	Retinal_dystrophies
pentalogy of cantrell	pentalogy_of_Cantrell
xx testicular disorders of sex development 46	testicular_DSD
aicardi syndrome	Aicardi_Syndrome
composite lymphoma	composite_lymphoma
pycnodysostosis	pycnodysostosis
charge syndrome	CHARGE_syndrome
granulomatous mastitis	Granulomatous_Mastitis
renal nutcracker syndrome	nutcracker_syndrome
pudendal neuralgia	pudendal_neuralgia
